key	actor_switch	number_of_actors
#audio_entity_actors_tables;0;db/audio_entity_actors_tables/data__		
wh2_def_elf_female_default	Generic_Actor_Elf_Female_Dark_Default	14
wh2_def_elf_male_default	Generic_Actor_Elf_Male_Dark_Default	10
wh2_dlc11_cst_damned_knights	Generic_Actor_Damned_Knights	5
wh2_dlc11_cst_syreens	Generic_Actor_Syreens	3
wh2_dlc11_cst_zombie	Generic_Actor_cst_zombie	4
wh2_dlc11_depth_guard	Generic_Actor_Depth_Guard	3
wh2_dlc13_huntsman_male	Generic_Actor_Huntsman_Default	2
wh2_dlc14_Skaven_Master_Assassin_LORD	Generic_Actor_SKV_Master_Assassin_Default	2
wh2_dlc14_medusa	Generic_Actor_DEF_Bloodwrack_Medusa	2
wh2_dlc15_Hef_Arch_Mage	Generic_Actor_Elf_Female_High_Arch_Mage	2
wh2_dlc15_Snotling	Generic_Actor_Snotling_Pumpwagon	4
wh2_dlc15_troll_hag	Generic_Actor_River_Troll_Hag	2
wh2_dlc16_Great_Stag_Knights_ROR	Generic_Actor_Elf_Male_WoodElves_Great_Stag_Knights	2
wh2_dlc16_skaven_chieftan	Generic_Actor_Skaven_Chieftan	2
wh2_dlc16_skaven_packmaster	Generic_Actor_Skaven_Packmaster	2
wh2_dlc16_wef_glade_captain	Generic_Actor_Elf_Female_WoodElves_Glade_Captain	2
wh2_dlc16_wef_spellweaver	Generic_Actor_Elf_Female_WoodElves_Spellweaver	2
wh2_dlc17_bst_doombull	Generic_Actor_Doombull	2
wh2_dlc17_bst_wargor	Generic_Actor_Wargor	2
wh2_dlc17_chameleon_stalkers	Generic_Actor_Chameleon_Stalkers	5
wh2_dlc17_skink_oracle	Generic_Actor_Skink_Oracle	2
wh2_dlc_cst_animated_hulk	Generic_Actor_Animated_Hulk	3
wh2_dlc_tmb_liche_priest	Generic_Actor_tmb_Liche_Priest	2
wh2_dlc_tmb_necrotect	Generic_Actor_tmb_Necrotect	2
wh2_dlc_tmb_tomb_king	Generic_Actor_tmb_Tomb_King	2
wh2_dlc_tmb_tomb_prince	Generic_Actor_tmb_Tomb_Prince	2
wh2_hef_elf_female_default	Generic_Actor_Elf_Female_High_Default	11
wh2_hef_elf_male_default	Generic_Actor_Elf_Male_High_Default	13
wh2_rat_ogre	Generic_Actor_Rat_Ogre	3
wh2_saurus	Generic_Actor_Saurus	2
wh2_skaven	Generic_Actor_Skaven	7
wh2_skaven_assassin	Generic_Actor_Skaven_Assassin	2
wh2_skaven_grey_seer	Generic_Actor_Skaven_Grey_Seer	2
wh2_skaven_plague_priests	Generic_Actor_Skaven_Plague_Priests	2
wh2_skaven_sorcerer	Generic_Actor_Skaven_Sorcerer	2
wh2_skaven_warlock	Generic_Actor_Skaven_Warlock	2
wh2_skaven_warlord	Generic_Actor_Skaven_Warlord	2
wh2_skinks	Generic_Actor_Skinks	7
wh2_slann	Generic_Actor_Slann	2
wh2_tmb_ushabti	Generic_Actor_Ushabti	5
wh2_twa04_bst_Great_Bray_Shaman	Generic_Actor_Great_Bray_Shaman	2
wh2_twa05_ogre_mercs	Generic_Actor_Ogre_Unit	5
wh3_cth_alchemist	Generic_Actor_Cathay_Alchemist	2
wh3_cth_astromancer	Generic_Actor_Cathay_Astromancer	2
wh3_cth_human_female	Generic_Actor_Human_Female_Cathay	6
wh3_cth_human_male	Generic_Actor_Human_Male_Cathay	5
wh3_cth_lord_magistrate	Generic_Actor_Cathay_Lord_Magistrate	2
wh3_cth_shugengan_lord	Generic_Actor_Cathay_Shugengan_Lord	2
wh3_dlc20_kho_chaos_exalted_hero	Generic_Actor_dlc20_Champions_Exalted_Hero_of_Khorne	2
wh3_dlc20_kho_chaos_lord	Generic_Actor_dlc20_Champions_Lord_of_Khorne	2
wh3_dlc20_nur_chaos_exalted_hero	Generic_Actor_dlc20_Champions_Exalted_Hero_of_Nurgle	2
wh3_dlc20_nur_chaos_sorcerer_lord	Generic_Actor_dlc20_Champions_Lord_of_Nurgle	2
wh3_dlc20_sla_chaos_lord	Generic_Actor_dlc20_Champions_Lord_of_Slaanesh	2
wh3_dlc20_sla_chaos_sorcerer_LH	Generic_Actor_dlc20_Champions_Sorcerer_of_Slaanesh	2
wh3_dlc20_tze_chaos_sorcerer	Generic_Actor_dlc20_Champions_Sorcerer_of_Tzeentch	2
wh3_dlc20_tze_chaos_sorcerer_lord	Generic_Actor_dlc20_Champions_Lord_of_Tzeentch	2
wh3_dlc21_cst_shadewraith_gunners	Generic_Actor_dlc21_Shadewraith_Gunners	3
wh3_dlc23_chd_bull_centaur	Generic_Actor_Chaos_Dwarf_Bull_Centaur	3
wh3_dlc23_chd_bull_centaur_taurruk	Generic_Actor_Chaos_Dwarf_Bull_Centaur_Taurruk	2
wh3_dlc23_chd_daemonsmith	Generic_Actor_Chaos_Dwarf_Daemonsmith	2
wh3_dlc23_chd_hobgoblin	Generic_Actor_Chaos_Dwarf_Hobgoblin	4
wh3_dlc23_chd_infernal_castellan	Generic_Actor_Chaos_Dwarf_Infernal_Castellan	2
wh3_dlc23_chd_overseer	Generic_Actor_Chaos_Dwarf_Overseer	2
wh3_dlc23_chd_sorcerer_prophet	Generic_Actor_Chaos_Dwarf_Sorcerer_Prophet	2
wh3_dlc23_chd_unit	Generic_Actor_Chaos_Dwarf_Unit	8
wh3_dlc25_nur_plagueogres	Generic_Actor_Nurgle_Plagueogre	2
wh3_dlc26_kho_mnt_fleshhound	Generic_Actor_Khorne_Fleshhound	2
wh3_dlc26_kho_skullreaper_units	Generic_Actor_Khorne_Skullreapers	3
wh3_dlc26_kho_wrathmonger_units	Generic_Actor_Khorne_Wrathmongers	3
wh3_dlc26_ogr_maneater_units	Generic_Actor_dlc26_Ogre_Maneater_Unit	3
wh3_dlc27_hef_ships_company	Generic_Actor_dlc27_Ships_Company_Unit	4
wh3_dlc27_nor_cursd_ettin	Generic_Actor_dlc27_Cursd_Ettin_Unit	4
wh3_dlc27_nor_marauders	Generic_Actor_dlc27_NOR_Marauder_Unit	4
wh3_dlc27_sla_champions_of_slaanesh	Generic_Actor_dlc27_Champions_of_Slaanesh_Unit	4
wh3_dlc27_sla_devotees_of_slaanesh	Generic_Actor_dlc27_DevoteesOfSlaanesh_Unit	2
wh3_dlc27_sla_pleasureseekers	Generic_Actor_dlc27_Pleasureseeker_Unit	4
wh3_gnoblar	Generic_Actor_Gnoblar	5
wh3_kho_bloodletter	Generic_Actor_Khorne_Bloodletters	4
wh3_kho_bloodreaper_LORD	Generic_Actor_Khorne_Bloodreaper	2
wh3_kho_bloodthirster_LH	Generic_Actor_Khorne_Bloodthirster_Unit	2
wh3_kho_chaos_warrior	Generic_Actor_Khorne_Chaos_Warrior	5
wh3_kho_cultist_LH	Generic_Actor_Khorne_Cultist	2
wh3_kho_exalted_bloodthirster_LORD	Generic_Actor_Khorne_Exalted_Bloodthirster	2
wh3_kho_fleshhound	Generic_Actor_Khorne_Fleshhound	2
wh3_kho_herald_LORD	Generic_Actor_Khorne_Herald	2
wh3_ksl_boyar	Generic_Actor_Kislev_Boyar	2
wh3_ksl_frost_maiden	Generic_Actor_Kislev_Frost_Maiden	2
wh3_ksl_human_female	Generic_Actor_Human_Female_Kislev	2
wh3_ksl_human_male	Generic_Actor_Human_Male_Kislev	8
wh3_ksl_ice_witch	Generic_Actor_Kislev_Ice_Witch	2
wh3_ksl_patriarch	Generic_Actor_Kislev_Patriarch	2
wh3_nur_cultist_LH	Generic_Actor_Nurgle_Cultist	2
wh3_nur_exalted_great_unclean_one_LORD	Generic_Actor_Nurgle_Exalted_Great_Unclean_One	2
wh3_nur_great_unclean_one_LH	Generic_Actor_Nurgle_Great_Unclean_One	2
wh3_nur_nurgling	Generic_Actor_Nurgle_Nurgling	1
wh3_nur_plaguebearer	Generic_Actor_Nurgle_Plaguebearer	6
wh3_nur_plaguebearer_herald	Generic_Actor_Nurgle_Herald	2
wh3_nur_plagueridden	Generic_Actor_Nurgle_Plagueridden	2
wh3_ogr_butcher_LH	Generic_Actor_Ogre_Butcher	2
wh3_ogr_firebelly_LH	Generic_Actor_Ogre_Firebelly	2
wh3_ogr_hunter_LH	Generic_Actor_Ogre_Hunter	2
wh3_ogr_ogre_units	Generic_Actor_Ogre_Unit	5
wh3_ogr_slaugtermaster_LORD	Generic_Actor_Ogre_Slaughtermaster	2
wh3_ogr_tyrant_LORD	Generic_Actor_Ogre_Tyrant	2
wh3_ogre_sabretusk	Generic_Actor_Khorne_Fleshhound	2
wh3_sla_alluress_LH	Generic_Actor_Slaanesh_Alluress	2
wh3_sla_cultist_LH	Generic_Actor_Slaanesh_Cultist	2
wh3_sla_daemonettes	Generic_Actor_Slaanesh_Daemonette	4
wh3_sla_exalted_keeper_of_secrets_LORD	Generic_Actor_Slaanesh_Exalted_Keeper_of_Secrets	2
wh3_sla_hellstrider	Generic_Actor_Slaanesh_Hellstrider	6
wh3_sla_herald_LORD	Generic_Actor_Slaanesh_Herald	2
wh3_sla_keeper_of_secrets_LORD	Generic_Actor_Slaanesh_Keeper_of_Secrets	2
wh3_tze_cultist_LH	Generic_Actor_Tzeentch_Cultist	2
wh3_tze_enlightened_knights	Generic_Actor_Tzeentch_Enlightened_Knights	4
wh3_tze_exalted_lord_of_change_LORD	Generic_Actor_Tzeentch_Exalted_Lord_of_Change	2
wh3_tze_herald_LORD	Generic_Actor_Tzeentch_Herald	2
wh3_tze_iridescent_LH	Generic_Actor_Tzeentch_Iridescent	2
wh3_tze_lord_of_change	Generic_Actor_Tzeentch_Lord_of_Change	2
wh_chaos_default	Generic_Actor_Chaos_Default	5
wh_chaos_marauder	Generic_Actor_Chaos_Marauder	5
wh_chaos_marauder_chieftan	Generic_Actor_Chaos_Marauder_Chieftan	2
wh_chaos_shaman_sorcerer	Generic_Actor_Chaos_Shaman_Sorcerer	2
wh_dwarf_default	Generic_Actor_Dwarf_Default	5
wh_dwarf_runesmith	Generic_Actor_Dwarf_Runesmith	2
wh_elf_female	Generic_Actor_Elf_Female_WoodElves	5
wh_elf_male	Generic_Actor_Elf_Male_WoodElves	5
wh_goblin	Generic_Actor_Goblin	8
wh_human_female	Generic_Actor_Human_Female	5
wh_human_male	Generic_Actor_Human_Male	16
wh_necromancer_male	Generic_Actor_Necromancer_Male	3
wh_orc	Generic_Actor_Orc	12
wh_vampire_female	Generic_Actor_Vampire_Female	2
wh_vampire_male	Generic_Actor_Vampire_Male	2
wh_zombie	Generic_Actor_Zombie	5
