key	algorithm	algorithm_variable_set	action_category_budget
#cai_decision_policies_tables;1;db/cai_decision_policies_tables/data__			
allied_buildings_policy_default	pick_best	pick_probabilistically	
cathay_caravan_start	weighted_random_select		
cathay_compass_policy_default	weighted_random_select		
cathay_provincial_initiative_policy_default	weighted_random_select		
changing_of_the_ways_actions_default	pick_best		
changing_of_the_ways_actions_easy	pick_best		
changing_of_the_ways_actions_hard	pick_best		
chaos_dwarf_convoy_start	weighted_random_select		
daemon_prince_ascension_default	pick_best		
deploy_ogre_camp_policy_default	pick_best	pick_probabilistically	
festus_plague_create_plague_default	weighted_random_select		
great_game_default	weighted_random_select		
khorne_skulls_policy_default	pick_best	pick_probabilistically	
kislev_motherland_default	weighted_random_select		
manipulate_diplomacy_default	pick_best		
manipulate_diplomacy_default_minor	pick_best		
manipulate_diplomacy_easy	pick_best		
manipulate_diplomacy_easy_minor	pick_best		
manipulate_diplomacy_hard	pick_best		
manipulate_diplomacy_hard_minor	pick_best		
manipulate_winds_of_magic_level_policy_default	pick_best	pick_probabilistically	
nurgle_plague_create_plague_default	weighted_random_select		
nurgle_plague_old_default	weighted_random_select		
occupation_decision_anti_chaos	weighted_random_select		
occupation_decision_beastmen	weighted_random_select		
occupation_decision_brettonia	weighted_random_select		
occupation_decision_cathay	weighted_random_select		
occupation_decision_changeling	weighted_random_select		
occupation_decision_chaos	weighted_random_select		
occupation_decision_chaos_daemon_prince_khorne_tzeentch	weighted_random_select		
occupation_decision_chaos_daemon_prince_nurgle_slaanesh	weighted_random_select		
occupation_decision_chaos_dwarfs	weighted_random_select		
occupation_decision_chaos_kho	weighted_random_select		
occupation_decision_daemons	weighted_random_select		
occupation_decision_default	weighted_random_select		
occupation_decision_empire_elector_major	weighted_random_select		
occupation_decision_nakai	weighted_random_select		
occupation_decision_only_raze	pick_best		
occupation_decision_raider	weighted_random_select		
occupation_decision_sacking	weighted_random_select		
occupation_decision_skaven	weighted_random_select		
occupation_decision_vampire	weighted_random_select		
occupation_decision_vampirecoast	weighted_random_select		
occupation_decision_wood_elves	weighted_random_select		
ogre_great_maw_policy_default	weighted_random_select		
promise_of_perfection_default	weighted_random_select		
promise_of_perfection_hard	weighted_random_select		
rift_realm_default	pick_best		
rift_teleport_antichaos	weighted_random_select		
rift_teleport_chaos	weighted_random_select		
rift_teleport_default	weighted_random_select		
slaanesh_force_vassalization_policy	pick_best		
slaanesh_pleasure_activities_policy_default	pick_best		
slaanesh_spawn_cult_policy_default	pick_best		
summon_disciple_army_policy_default	pick_best	pick_probabilistically	
trespass_warning_accept_default	pick_best		
undeploy_ogre_camp_policy_default	pick_best	pick_probabilistically	
wh3_character_initiatives_chs_azazel	weighted_random_select		
wh3_character_initiatives_chs_festus	weighted_random_select		
wh3_character_initiatives_chs_valkia	weighted_random_select		
wh3_character_initiatives_chs_vilitch	weighted_random_select		
wh3_character_initiatives_chs_warriors	weighted_random_select		
wh3_character_initiatives_ogr	weighted_random_select		
wh3_dlc20_tze_cotw_vilitch	pick_best		
wh3_faction_initiatives_chd_hellforge_bull_centaurs	weighted_random_select	pick_four_items	
wh3_faction_initiatives_chd_hellforge_flying_beasts	weighted_random_select	pick_four_items	
wh3_faction_initiatives_chd_hellforge_kdaai	weighted_random_select	pick_four_items	
wh3_faction_initiatives_chd_hellforge_melee_infantry	weighted_random_select	pick_four_items	
wh3_faction_initiatives_chd_hellforge_missile_infantry	weighted_random_select	pick_four_items	
wh3_faction_initiatives_chd_hellforge_warmachines_artillery	weighted_random_select	pick_four_items	
wh3_faction_initiatives_chs_azazel	weighted_random_select		
wh3_faction_initiatives_chs_festus	weighted_random_select		
wh3_faction_initiatives_chs_valkia	weighted_random_select		
wh3_faction_initiatives_chs_vilitch	weighted_random_select		
wh3_faction_initiatives_woc_default	weighted_random_select		
wh3_province_initiatives_brt	pick_best		
wh3_province_initiatives_chd	pick_best		
wh3_province_initiatives_chs_archaon	pick_best		
wh3_province_initiatives_chs_azazel	pick_best		
wh3_province_initiatives_chs_festus	pick_best		
wh3_province_initiatives_chs_kholek	pick_best		
wh3_province_initiatives_chs_sigvald	pick_best		
wh3_province_initiatives_chs_valkia	pick_best		
wh3_province_initiatives_chs_vilitch	pick_best		
wh3_province_initiatives_cst	pick_best		
wh3_province_initiatives_cth	pick_best		
wh3_province_initiatives_dae	pick_best		
wh3_province_initiatives_def	pick_best		
wh3_province_initiatives_dwf	pick_best		
wh3_province_initiatives_emp	pick_best		
wh3_province_initiatives_grn	pick_best		
wh3_province_initiatives_hef	pick_best		
wh3_province_initiatives_kho	pick_best		
wh3_province_initiatives_ksl	pick_best		
wh3_province_initiatives_lzd	pick_best		
wh3_province_initiatives_nor	pick_best		
wh3_province_initiatives_nur	pick_best		
wh3_province_initiatives_ogr	pick_best		
wh3_province_initiatives_skv	pick_best		
wh3_province_initiatives_sla	pick_best		
wh3_province_initiatives_tmb	pick_best		
wh3_province_initiatives_tze	pick_best		
wh3_province_initiatives_vmp	pick_best		
wh3_ritual_belakor_great_game	pick_best		
wh3_ritual_chd_tower_of_zharr_astragoth	weighted_random_select		
wh3_ritual_chd_tower_of_zharr_drazoath	weighted_random_select		
wh3_ritual_chd_tower_of_zharr_zhatan	weighted_random_select		
wh3_ritual_chd_unit_caps	weighted_random_select		characters
wh3_ritual_cst_rites	pick_best		
wh3_ritual_cth_matters_of_state	pick_best		
wh3_ritual_def_hellebron_rites	pick_best		
wh3_ritual_def_lokhir_rites	pick_best		
wh3_ritual_def_malus_rites	pick_best		
wh3_ritual_def_rites	pick_best		
wh3_ritual_def_slave_actions	pick_best		
wh3_ritual_dwf_crafting	pick_best		
wh3_ritual_hef_alarielle_rites	pick_best		
wh3_ritual_hef_alithanar_rites	pick_best		
wh3_ritual_hef_eltharion_rites	pick_best		
wh3_ritual_hef_imrik_rites	pick_best		
wh3_ritual_hef_rites	pick_best		
wh3_ritual_lzd_gorrok_rites	pick_best		
wh3_ritual_lzd_nakai_rites	pick_best		
wh3_ritual_lzd_pyramid	pick_best		
wh3_ritual_lzd_rites	pick_best		
wh3_ritual_lzd_temple	pick_best		
wh3_ritual_lzd_tiktaqto_rites	pick_best		
wh3_ritual_skv_ikit_rites	pick_best		
wh3_ritual_skv_queek_rites	pick_best		
wh3_ritual_skv_rites	pick_best		
wh3_ritual_skv_skrolk_rites	pick_best		
wh3_ritual_skv_snikch_rites	pick_best		
wh3_ritual_skv_throt_rites	pick_best		
wh3_ritual_skv_tretch_rites	pick_best		
wh3_ritual_skv_workshop	weighted_random_select		
wh3_ritual_tmb_crafting	pick_best		
wh3_ritual_tmb_rites	pick_best		
wh3_ritual_vmp_bloodlines	pick_best		
wh3_ritual_vmp_bloodlines_lahmia	pick_best		
wh3_ritual_vmp_bloodlines_necrach	pick_best		
wh3_ritual_vmp_bloodlines_voncarstein	pick_best		
wh3_ritual_wef_forge_dragon	pick_best		
wh3_ritual_wef_forge_dreaming	pick_best		
wh3_ritual_wef_forge_eagle	pick_best		
wh3_ritual_wef_forge_twilight	pick_best		
