banner	effect_bundle
#banners_tables;1;db/banners_tables/data__	
wh2_dlc09_banner_magic_standard_banner_of_the_hidden_dead	wh2_dlc09_bundle_anc_magic_standard_banner_of_the_hidden_dead
wh2_dlc09_banner_magic_standard_standard_of_the_undying_legion	wh2_dlc09_bundle_anc_magic_standard_standard_of_the_undying_legion
wh2_dlc10_banner_magic_standard_banner_of_avelorn	wh2_dlc10_bundle_anc_magic_standard_banner_of_avelorn
wh2_dlc11_banner_magic_standard_bloodied_banner_of_slayers	wh2_dlc11_bundle_anc_magic_standard_bloodied_banner_of_slayers
wh2_dlc11_banner_magic_standard_boatswain	wh2_dlc11_bundle_anc_magic_standard_boatswain
wh2_dlc11_banner_magic_standard_burnt_banner_of_knights	wh2_dlc11_bundle_anc_magic_standard_burnt_banner_of_knights
wh2_dlc11_banner_magic_standard_corpse_surgeon	wh2_dlc11_bundle_anc_magic_standard_corpse_surgeon
wh2_dlc11_banner_magic_standard_dead_mans_chest	wh2_dlc11_bundle_anc_magic_standard_dead_mans_chest
wh2_dlc11_banner_magic_standard_holed_banner_of_militia	wh2_dlc11_bundle_anc_magic_standard_holed_banner_of_militia
wh2_dlc11_banner_magic_standard_rookie_gunner	wh2_dlc11_bundle_anc_magic_standard_rookie_gunner
wh2_dlc11_banner_magic_standard_ships_colors	wh2_dlc11_bundle_anc_magic_standard_ships_colors
wh2_dlc11_banner_magic_standard_skull_and_crossbones	wh2_dlc11_bundle_anc_magic_standard_skull_and_crossbones
wh2_dlc11_banner_magic_standard_spell_of_the_necromancers_apprentice	wh2_dlc11_bundle_anc_magic_standard_spell_of_the_necromancers_apprentice
wh2_dlc11_banner_magic_standard_throwing_bombs	wh2_dlc11_bundle_anc_magic_standard_throwing_bombs
wh2_dlc11_banner_magic_standard_torn_banner_of_pilgrims	wh2_dlc11_bundle_anc_magic_standard_torn_banner_of_pilgrims
wh2_dlc12_anc_banner_tracer_rounds	wh2_dlc12_bundle_anc_magic_standard_tracer_rounds
wh2_dlc12_banner_magic_standard_cape_of_sniper	wh2_dlc12_bundle_anc_magic_standard_cape_of_sniper
wh2_dlc12_banner_magic_standard_coatlpelt_flagstaff	wh2_dlc12_bundle_anc_magic_standard_coatlpelt_flagstaff
wh2_dlc12_banner_magic_standard_culchan_feathered_standard	wh2_dlc12_bundle_anc_magic_standard_culchan_feathered_standard
wh2_dlc12_banner_magic_standard_exalted_banner_of_xapati	wh2_dlc12_bundle_anc_magic_standard_exalted_banner_of_xapati
wh2_dlc12_banner_magic_standard_flag_of_the_daystar	wh2_dlc12_bundle_anc_magic_standard_flag_of_the_daystar
wh2_dlc12_banner_magic_standard_incendiary_rounds	wh2_dlc12_bundle_anc_magic_standard_incendiary_rounds
wh2_dlc12_banner_magic_standard_shroud_of_chaqua	wh2_dlc12_bundle_anc_magic_standard_shroud_of_chaqua
wh2_dlc12_banner_magic_standard_sign_of_the_coiled_one	wh2_dlc12_bundle_anc_magic_standard_sign_of_the_coiled_one
wh2_dlc12_banner_magic_standard_totem_of_the_spitting_viper	wh2_dlc12_bundle_anc_magic_standard_totem_of_the_spitting_viper
wh2_dlc12_banner_magic_standard_totem_pole_of_destiny	wh2_dlc12_bundle_anc_magic_standard_totem_pole_of_destiny
wh2_dlc14_anc_banner_jean_claude_sartre	wh2_dlc14_bundle_banner_jean_claude_sartre
wh2_dlc14_anc_banner_pierre_darden	wh2_dlc14_bundle_banner_pierre_darden
wh2_dlc14_anc_banner_rene_de_cartes	wh2_dlc14_bundle_banner_rene_de_cartes
wh2_dlc14_anc_follower_malus_bruglir	wh2_dlc14_anc_follower_malus_bruglir
wh2_dlc14_anc_follower_malus_hathan_gul	wh2_dlc14_anc_follower_malus_hathan_gul
wh2_dlc14_anc_follower_malus_lhunara	wh2_dlc14_anc_follower_malus_lhunara
wh2_dlc14_anc_follower_malus_silar	wh2_dlc14_anc_follower_malus_silar
wh2_dlc15_anc_magic_standard_blacktoofs_head_in_a_jar	wh2_dlc15_anc_magic_standard_blacktoofs_head_in_a_jar
wh2_dlc17_anc_banner_bst_banner_of_ghorok	wh2_dlc17_anc_banner_bst_banner_of_ghorok
wh2_dlc17_anc_banner_bst_banner_of_madness	wh2_dlc17_anc_banner_bst_banner_of_madness
wh2_dlc17_anc_banner_bst_banner_of_unholy_exultation	wh2_dlc17_anc_banner_bst_banner_of_unholy_exultation
wh2_dlc17_anc_banner_lzd_poison_daemonbane	wh2_dlc17_anc_banner_lzd_poison_daemonbane
wh2_dlc17_anc_banner_lzd_poison_fireblood_toxin	wh2_dlc17_anc_banner_lzd_poison_fireblood_toxin
wh2_dlc17_anc_banner_lzd_poison_slow_death	wh2_dlc17_anc_banner_lzd_poison_slow_death
wh2_dlc17_anc_banner_lzd_poison_toadskin_essence	wh2_dlc17_anc_banner_lzd_poison_toadskin_essence
wh2_dlc17_anc_blessing_of_filth_banner	wh2_dlc17_anc_blessing_of_filth_banner
wh2_dlc17_anc_blessing_of_mania_banner	wh2_dlc17_anc_blessing_of_mania_banner
wh2_dlc17_anc_blessing_of_trickery_banner	wh2_dlc17_anc_blessing_of_trickery_banner
wh2_dlc17_anc_dread_retainer_fimir_banner	wh2_dlc17_anc_dread_retainer_fimir_banner
wh2_dlc17_anc_dread_retainer_skinwolf_banner	wh2_dlc17_anc_dread_retainer_skinwolf_banner
wh2_dlc17_anc_dread_retainer_troll_banner	wh2_dlc17_anc_dread_retainer_troll_banner
wh2_dlc17_anc_rune_engineering_flakksons_rune_of_seeking	wh2_dlc17_anc_rune_engineering_flakksons_rune_of_seeking
wh2_dlc17_anc_rune_engineering_master_rune_of_disguise	wh2_dlc17_anc_rune_engineering_master_rune_of_disguise
wh2_dlc17_anc_rune_engineering_master_rune_of_immolation	wh2_dlc17_anc_rune_engineering_master_rune_of_immolation
wh2_dlc17_anc_rune_engineering_rune_of_burning	wh2_dlc17_anc_rune_engineering_rune_of_burning
wh2_dlc17_anc_rune_engineering_rune_of_penetration	wh2_dlc17_anc_rune_engineering_rune_of_penetration
wh2_dlc17_dummy_banner	wh2_dlc17_empty_bundle
wh2_main_banner_magic_standard_banner_of_ellyrion	wh2_main_bundle_anc_magic_standard_banner_of_ellyrion
wh2_main_banner_magic_standard_banner_of_murder	wh2_main_bundle_anc_magic_standard_banner_of_murder
wh2_main_banner_magic_standard_banner_of_the_under_empire	wh2_main_bundle_anc_magic_standard_banner_of_the_under_empire
wh2_main_banner_magic_standard_banner_of_the_world_dragon	wh2_main_bundle_anc_magic_standard_banner_of_the_world_dragon
wh2_main_banner_magic_standard_banner_of_verminous_scurrying	wh2_main_bundle_anc_magic_standard_banner_of_verminous_scurrying
wh2_main_banner_magic_standard_battle_banner	wh2_main_bundle_anc_magic_standard_battle_banner
wh2_main_banner_magic_standard_dread_banner	wh2_main_bundle_anc_magic_standard_dread_banner
wh2_main_banner_magic_standard_dwarf_hide_banner	wh2_main_bundle_anc_magic_standard_dwarf_hide_banner
wh2_main_banner_magic_standard_grand_banner_of_clan_superiority	wh2_main_bundle_anc_magic_standard_grand_banner_of_clan_superiority
wh2_main_banner_magic_standard_horn_of_isha	wh2_main_bundle_anc_magic_standard_horn_of_isha
wh2_main_banner_magic_standard_huanchis_blessed_totem	wh2_main_bundle_anc_magic_standard_huanchis_blessed_totem
wh2_main_banner_magic_standard_hydra_banner	wh2_main_bundle_anc_magic_standard_hydra_banner
wh2_main_banner_magic_standard_lion_standard	wh2_main_bundle_anc_magic_standard_lion_standard
wh2_main_banner_magic_standard_sacred_banner_of_the_horned_rat	wh2_main_bundle_anc_magic_standard_sacred_banner_of_the_horned_rat
wh2_main_banner_magic_standard_sea_serpent_standard	wh2_main_bundle_anc_magic_standard_sea_serpent_standard
wh2_main_banner_magic_standard_shroud_of_dripping_death	wh2_main_bundle_anc_magic_standard_shroud_of_dripping_death
wh2_main_banner_magic_standard_skavenpelt_banner	wh2_main_bundle_anc_magic_standard_skavenpelt_banner
wh2_main_banner_magic_standard_standard_of_hag_graef	wh2_main_bundle_anc_magic_standard_standard_of_hag_graef
wh2_main_banner_magic_standard_storm_banner	wh2_main_bundle_anc_magic_standard_storm_banner
wh2_main_banner_magic_standard_sun_standard_of_chotec	wh2_main_bundle_anc_magic_standard_sun_standard_of_chotec
wh2_main_banner_magic_standard_sunburst_standard_of_hexoatl	wh2_main_bundle_anc_magic_standard_sunburst_standard_of_hexoatl
wh2_main_banner_magic_standard_the_blood_banner	wh2_main_bundle_anc_magic_standard_the_blood_banner
wh2_main_banner_magic_standard_the_jaguar_standard	wh2_main_bundle_anc_magic_standard_the_jaguar_standard
wh2_main_banner_magic_standard_totem_of_prophecy	wh2_main_bundle_anc_magic_standard_totem_of_prophecy
wh3_dlc23_anc_banner_chd_banner_of_the_khanate	wh3_dlc23_anc_banner_chd_banner_of_the_khanate
wh3_dlc23_anc_banner_chd_eye_of_hashut	wh3_dlc23_anc_banner_chd_eye_of_hashut
wh3_dlc23_anc_banner_chd_hellbound_standard	wh3_dlc23_anc_banner_chd_hellbound_standard
wh3_dlc23_anc_banner_chd_hobgoblin_standard	wh3_dlc23_anc_banner_chd_hobgoblin_standard
wh3_dlc23_anc_banner_chd_oath_of_contempt	wh3_dlc23_anc_banner_chd_oath_of_contempt
wh3_dlc23_anc_banner_chd_standard_of_zharr	wh3_dlc23_anc_banner_chd_standard_of_zharr
wh3_dlc24_anc_cth_magistrate_specialist_infantry_hunter	wh3_dlc24_anc_cth_magistrate_specialist_infantry_hunter
wh3_dlc24_anc_cth_magistrate_specialist_infiltrator	wh3_dlc24_anc_cth_magistrate_specialist_infiltrator
wh3_dlc24_anc_cth_magistrate_specialist_monster_hunter	wh3_dlc24_anc_cth_magistrate_specialist_monster_hunter
wh3_dlc25_anc_banner_arachnarok_trophy	wh3_dlc25_anc_banner_arachnarok_trophy
wh3_dlc25_anc_banner_dragon_hide_cloaks	wh3_dlc25_anc_banner_dragon_hide_cloaks
wh3_dlc25_anc_banner_emp_doomfire_ring	wh3_dlc25_anc_banner_emp_doomfire_ring
wh3_dlc25_anc_banner_emp_everwood_root	wh3_dlc25_anc_banner_emp_everwood_root
wh3_dlc25_anc_banner_emp_frostfire_gem	wh3_dlc25_anc_banner_emp_frostfire_gem
wh3_dlc25_anc_banner_rune_of_the_furnace	wh3_dlc25_anc_banner_rune_of_the_furnace
wh3_dlc26_anc_banner_tmb_centuries_sigil	wh3_main_anc_banner_tmb_centuries_sigil
wh3_dlc26_anc_banner_tmb_cursing_word	wh3_main_anc_banner_tmb_cursing_word
wh3_dlc26_anc_banner_tmb_khsar_fury	wh3_main_anc_banner_tmb_khsar_fury
wh3_dlc26_anc_banner_tmb_royal_standard_settra	wh3_main_anc_banner_tmb_royal_standard_settra
wh3_dlc26_anc_banner_tmb_sacred_eye	wh3_main_anc_banner_tmb_sacred_eye
wh3_dlc26_anc_banner_tmb_ualatp_order	wh3_main_anc_banner_tmb_ualatp_order
wh3_dlc26_golgfag_contract_anc_banner_berserk	wh3_dlc26_golgfag_contract_anc_banner_berserk
wh3_dlc26_golgfag_contract_anc_banner_black_dragon_egg	wh3_dlc26_golgfag_contract_anc_banner_black_dragon_egg
wh3_dlc26_golgfag_contract_anc_banner_black_powder_aplenty	wh3_dlc26_golgfag_contract_anc_banner_black_powder_aplenty
wh3_dlc26_golgfag_contract_anc_banner_blackpowder_discipline	wh3_dlc26_golgfag_contract_anc_banner_blackpowder_discipline
wh3_dlc26_golgfag_contract_anc_banner_blast_proof_gutplates	wh3_dlc26_golgfag_contract_anc_banner_blast_proof_gutplates
wh3_dlc26_golgfag_contract_anc_banner_blessing_of_the_lady	wh3_dlc26_golgfag_contract_anc_banner_blessing_of_the_lady
wh3_dlc26_golgfag_contract_anc_banner_bomb_throw	wh3_dlc26_golgfag_contract_anc_banner_bomb_throw
wh3_dlc26_golgfag_contract_anc_banner_bone_muncha	wh3_dlc26_golgfag_contract_anc_banner_bone_muncha
wh3_dlc26_golgfag_contract_anc_banner_brooding_maneaters	wh3_dlc26_golgfag_contract_anc_banner_brooding_maneaters
wh3_dlc26_golgfag_contract_anc_banner_bulwark_of_the_gate	wh3_dlc26_golgfag_contract_anc_banner_bulwark_of_the_gate
wh3_dlc26_golgfag_contract_anc_banner_by_our_blood	wh3_dlc26_golgfag_contract_anc_banner_by_our_blood
wh3_dlc26_golgfag_contract_anc_banner_dark_benediction	wh3_dlc26_golgfag_contract_anc_banner_dark_benediction
wh3_dlc26_golgfag_contract_anc_banner_deflection_training	wh3_dlc26_golgfag_contract_anc_banner_deflection_training
wh3_dlc26_golgfag_contract_anc_banner_flag_of_blood_keep	wh3_dlc26_golgfag_contract_anc_banner_flag_of_blood_keep
wh3_dlc26_golgfag_contract_anc_banner_glorious_charge	wh3_dlc26_golgfag_contract_anc_banner_glorious_charge
wh3_dlc26_golgfag_contract_anc_banner_guardians_of_the_wildwood	wh3_dlc26_golgfag_contract_anc_banner_guardians_of_the_wildwood
wh3_dlc26_golgfag_contract_anc_banner_hawkish_precision	wh3_dlc26_golgfag_contract_anc_banner_hawkish_precision
wh3_dlc26_golgfag_contract_anc_banner_hellforge_blades	wh3_dlc26_golgfag_contract_anc_banner_hellforge_blades
wh3_dlc26_golgfag_contract_anc_banner_horned_rat	wh3_dlc26_golgfag_contract_anc_banner_horned_rat
wh3_dlc26_golgfag_contract_anc_banner_lion_cloak	wh3_dlc26_golgfag_contract_anc_banner_lion_cloak
wh3_dlc26_golgfag_contract_anc_banner_maneater_knights	wh3_dlc26_golgfag_contract_anc_banner_maneater_knights
wh3_dlc26_golgfag_contract_anc_banner_maneater_woodsman	wh3_dlc26_golgfag_contract_anc_banner_maneater_woodsman
wh3_dlc26_golgfag_contract_anc_banner_martial_prowess	wh3_dlc26_golgfag_contract_anc_banner_martial_prowess
wh3_dlc26_golgfag_contract_anc_banner_murderous_prowess	wh3_dlc26_golgfag_contract_anc_banner_murderous_prowess
wh3_dlc26_golgfag_contract_anc_banner_night_goblin_toxins	wh3_dlc26_golgfag_contract_anc_banner_night_goblin_toxins
wh3_dlc26_golgfag_contract_anc_banner_overwhelming_odour	wh3_dlc26_golgfag_contract_anc_banner_overwhelming_odour
wh3_dlc26_golgfag_contract_anc_banner_pigeon_bomb	wh3_dlc26_golgfag_contract_anc_banner_pigeon_bomb
wh3_dlc26_golgfag_contract_anc_banner_predatory_fighter	wh3_dlc26_golgfag_contract_anc_banner_predatory_fighter
wh3_dlc26_golgfag_contract_anc_banner_primal_instincts	wh3_dlc26_golgfag_contract_anc_banner_primal_instincts
wh3_dlc26_golgfag_contract_anc_banner_rage	wh3_dlc26_golgfag_contract_anc_banner_rage
wh3_dlc26_golgfag_contract_anc_banner_ratbag_tactics	wh3_dlc26_golgfag_contract_anc_banner_ratbag_tactics
wh3_dlc26_golgfag_contract_anc_banner_red_crest_toxins	wh3_dlc26_golgfag_contract_anc_banner_red_crest_toxins
wh3_dlc26_golgfag_contract_anc_banner_rotten_diet	wh3_dlc26_golgfag_contract_anc_banner_rotten_diet
wh3_dlc26_golgfag_contract_anc_banner_runes_of_protection	wh3_dlc26_golgfag_contract_anc_banner_runes_of_protection
wh3_dlc26_golgfag_contract_anc_banner_shield_of_distraction	wh3_dlc26_golgfag_contract_anc_banner_shield_of_distraction
wh3_dlc26_golgfag_contract_anc_banner_slayer	wh3_dlc26_golgfag_contract_anc_banner_slayer
wh3_dlc26_golgfag_contract_anc_banner_taunt	wh3_dlc26_golgfag_contract_anc_banner_taunt
wh3_dlc26_golgfag_contract_anc_banner_the_hungry	wh3_dlc26_golgfag_contract_anc_banner_the_hungry
wh3_dlc26_golgfag_contract_anc_banner_tools_of_judgement	wh3_dlc26_golgfag_contract_anc_banner_tools_of_judgement
wh3_dlc26_golgfag_contract_anc_banner_undying_will	wh3_dlc26_golgfag_contract_anc_banner_undying_will
wh3_dlc26_golgfag_contract_anc_banner_verminous_doom	wh3_dlc26_golgfag_contract_anc_banner_verminous_doom
wh3_dlc26_golgfag_contract_anc_banner_waaaagh	wh3_dlc26_golgfag_contract_anc_banner_waaaagh
wh3_dlc26_golgfag_contract_anc_banner_warpaint	wh3_dlc26_golgfag_contract_anc_banner_warpaint
wh3_dlc26_golgfag_contract_anc_banner_witchbrew	wh3_dlc26_golgfag_contract_anc_banner_witchbrew
wh3_dlc26_golgfag_contract_anc_banner_worthy_foe	wh3_dlc26_golgfag_contract_anc_banner_worthy_foe
wh3_dlc26_golgfag_contract_anc_banner_yang	wh3_dlc26_golgfag_contract_anc_banner_yang
wh3_dlc26_golgfag_contract_anc_banner_yin	wh3_dlc26_golgfag_contract_anc_banner_yin
wh3_main_anc_magic_standard_banner_of_the_moon_empress	wh3_main_bundle_anc_magic_standard_banner_of_the_moon_empress
wh3_main_anc_magic_standard_bastion_standard	wh3_main_bundle_anc_magic_standard_bastion_standard
wh3_main_anc_magic_standard_flag_of_grand_cathay	wh3_main_bundle_anc_magic_standard_flag_of_grand_cathay
wh3_main_anc_magic_standard_revered_banner_of_the_ancestors	wh3_main_bundle_anc_magic_standard_revered_banner_of_the_ancestors
wh3_main_anc_magic_standard_serene_cloud_prayer_flag	wh3_main_bundle_anc_magic_standard_serene_cloud_prayer_flag
wh3_main_anc_magic_standard_standard_of_nan_gau	wh3_main_bundle_anc_magic_standard_standard_of_nan_gau
wh3_main_anc_magic_standard_standard_of_shang_yang	wh3_main_bundle_anc_magic_standard_standard_of_shang_yang
wh3_main_anc_magic_standard_standard_of_wei_jin	wh3_main_bundle_anc_magic_standard_standard_of_wei_jin
wh3_main_banner_magic_standard_banner_of_change	wh3_main_bundle_anc_magic_standard_banner_of_change
wh3_main_banner_magic_standard_banner_of_ecstacy	wh3_main_bundle_anc_magic_standard_banner_of_ecstacy
wh3_main_banner_magic_standard_banner_of_feng_shi	wh3_main_bundle_anc_magic_standard_banner_of_feng_shi
wh3_main_banner_magic_standard_banner_of_hellfire	wh3_main_bundle_anc_magic_standard_banner_of_hellfire
wh3_main_banner_magic_standard_banner_of_praag	wh3_main_bundle_anc_magic_standard_banner_of_praag
wh3_main_banner_magic_standard_banner_of_the_empress_eye	wh3_main_bundle_anc_magic_standard_banner_of_the_empress_eye
wh3_main_banner_magic_standard_banner_of_the_orthodoxy	wh3_main_bundle_anc_magic_standard_banner_of_the_orthodoxy
wh3_main_banner_magic_standard_banner_of_unholy_victory	wh3_main_bundle_anc_magic_standard_banner_of_unholy_victory
wh3_main_banner_magic_standard_blood_feasters_banner	wh3_main_bundle_anc_magic_standard_blood_feasters_banner
wh3_main_banner_magic_standard_bull_standard	wh3_main_bundle_anc_magic_standard_bull_standard
wh3_main_banner_magic_standard_cannibal_totem	wh3_main_bundle_anc_magic_standard_cannibal_totem
wh3_main_banner_magic_standard_dragonhide_banner	wh3_main_bundle_anc_magic_standard_dragonhide_banner
wh3_main_banner_magic_standard_father_niklas_mantle	wh3_main_bundle_anc_magic_standard_father_niklas_mantle
wh3_main_banner_magic_standard_great_icon_of_despair	wh3_main_bundle_anc_magic_standard_great_icon_of_despair
wh3_main_banner_magic_standard_great_standard_of_sundering	wh3_main_bundle_anc_magic_standard_great_standard_of_sundering
wh3_main_banner_magic_standard_icon_of_endless_war	wh3_main_bundle_anc_magic_standard_icon_of_endless_war
wh3_main_banner_magic_standard_icon_of_eternal_virulence	wh3_main_bundle_anc_magic_standard_icon_of_eternal_virulence
wh3_main_banner_magic_standard_icon_of_sorcery	wh3_main_bundle_anc_magic_standard_icon_of_sorcery
wh3_main_banner_magic_standard_khornes_gift	wh3_main_bundle_anc_magic_standard_khornes_gift
wh3_main_banner_magic_standard_lifetaker_banner	wh3_main_bundle_anc_magic_standard_lifetaker_banner
wh3_main_banner_magic_standard_ragbanner	wh3_main_bundle_anc_magic_standard_ragbanner
wh3_main_banner_magic_standard_rune_maw	wh3_main_bundle_anc_magic_standard_rune_maw
wh3_main_banner_magic_standard_siren_standard	wh3_main_bundle_anc_magic_standard_siren_standard
wh3_main_banner_magic_standard_skull_totem	wh3_main_bundle_anc_magic_standard_skull_totem
wh3_main_banner_magic_standard_standard_of_chaos_glory	wh3_main_bundle_anc_magic_standard_standard_of_chaos_glory
wh3_main_banner_magic_standard_standard_of_seeping_decay	wh3_main_bundle_anc_magic_standard_standard_of_seeping_decay
wh3_main_banner_magic_standard_standard_of_the_empty_steppe	wh3_main_bundle_anc_magic_standard_standard_of_the_empty_steppe
wh3_main_banner_magic_standard_the_great_celestial_banner	wh3_main_bundle_anc_magic_standard_the_great_celestial_banner
wh3_main_banner_magic_standard_trophy_of_killers	wh3_main_bundle_anc_magic_standard_trophy_of_killers
wh_dlc03_banner_magic_standard_banner_of_outrage	wh_dlc03_bundle_anc_magic_standard_banner_of_outrage
wh_dlc03_banner_magic_standard_banner_of_the_fallen_kings	wh_dlc03_bundle_anc_magic_standard_banner_of_the_fallen_kings
wh_dlc03_banner_magic_standard_manbane_standard	wh_dlc03_bundle_anc_magic_standard_manbane_standard
wh_dlc03_banner_magic_standard_the_beast_banner	wh_dlc03_bundle_anc_magic_standard_the_beast_banner
wh_dlc03_banner_magic_standard_totem_of_rust	wh_dlc03_bundle_anc_magic_standard_totem_of_rust
wh_dlc03_banner_mark_of_chaos_crown_of_horns	wh_dlc03_bundle_anc_mark_of_chaos_crown_of_horns
wh_dlc03_banner_mark_of_chaos_gnarled_hide	wh_dlc03_bundle_anc_mark_of_chaos_gnarled_hide
wh_dlc03_banner_mark_of_chaos_gouge_tusks	wh_dlc03_bundle_anc_mark_of_chaos_gouge_tusks
wh_dlc03_banner_mark_of_chaos_many_limbed_fiend	wh_dlc03_bundle_anc_mark_of_chaos_many_limbed_fiend
wh_dlc03_banner_mark_of_chaos_shadow_hide	wh_dlc03_bundle_anc_mark_of_chaos_shadow_hide
wh_dlc03_banner_mark_of_chaos_slug_skin	wh_dlc03_bundle_anc_mark_of_chaos_slug_skin
wh_dlc03_banner_mark_of_chaos_uncanny_senses	wh_dlc03_bundle_anc_mark_of_chaos_uncanny_senses
wh_dlc05_banner_magic_standard_the_banner_of_the_eternal_queen	wh_dlc05_bundle_anc_magic_standard_the_banner_of_the_eternal_queen
wh_dlc05_banner_magic_standard_the_banner_of_the_hunter_king	wh_dlc05_bundle_anc_magic_standard_the_banner_of_the_hunter_king
wh_dlc06_banner_magic_standard_skarsniks_boyz	wh_dlc06_bundle_anc_magic_standard_skarsniks_boyz
wh_dlc07_banner_magic_standard_banner_of_defence	wh_dlc07_bundle_anc_magic_standard_banner_of_defence
wh_dlc07_banner_magic_standard_errantry_banner	wh_dlc07_bundle_anc_magic_standard_errantry_banner
wh_dlc07_banner_magic_standard_twilight_banner	wh_dlc07_bundle_anc_magic_standard_twilight_banner
wh_dlc07_banner_magic_standard_valorous_standard	wh_dlc07_bundle_anc_magic_standard_valorous_standard
wh_dlc08_banner_magic_standard_ancient_mammoth_cub	wh_dlc08_bundle_anc_magic_standard_ancient_mammoth_cub
wh_dlc08_banner_magic_standard_banner_of_wolfclaw	wh_dlc08_bundle_anc_magic_standard_banner_of_wolfclaw
wh_dlc08_banner_magic_standard_black_iron_reavers	wh_dlc08_bundle_anc_magic_standard_black_iron_reavers
wh_dlc08_banner_magic_standard_crimson_reapers	wh_dlc08_bundle_anc_magic_standard_crimson_reapers
wh_dlc08_banner_magic_standard_drake_hunters	wh_dlc08_bundle_anc_magic_standard_drake_hunters
wh_main_banner_magic_standard_banner_of_eternal_flame	wh_main_bundle_anc_magic_standard_banner_of_eternal_flame
wh_main_banner_magic_standard_banner_of_lost_holds	wh_main_bundle_anc_magic_standard_banner_of_lost_holds
wh_main_banner_magic_standard_banner_of_rage	wh_main_bundle_anc_magic_standard_banner_of_rage
wh_main_banner_magic_standard_banner_of_swiftness	wh_main_bundle_anc_magic_standard_banner_of_swiftness
wh_main_banner_magic_standard_banner_of_the_barrows	wh_main_bundle_anc_magic_standard_banner_of_the_barrows
wh_main_banner_magic_standard_blasted_standard	wh_main_bundle_anc_magic_standard_blasted_standard
wh_main_banner_magic_standard_da_immortulz	wh_main_bundle_anc_magic_standard_da_immortulz
wh_main_banner_magic_standard_gleaming_pennant	wh_main_bundle_anc_magic_standard_gleaming_pennant
wh_main_banner_magic_standard_griffon_banner	wh_main_bundle_anc_magic_standard_griffon_banner
wh_main_banner_magic_standard_lichbone_pennant	wh_main_bundle_anc_magic_standard_lichbone_pennant
wh_main_banner_magic_standard_morks_war_banner	wh_main_bundle_anc_magic_standard_morks_war_banner
wh_main_banner_magic_standard_rampagers_standard	wh_main_bundle_anc_magic_standard_rampagers_standard
wh_main_banner_magic_standard_rangers_standard	wh_main_bundle_anc_magic_standard_rangers_standard
wh_main_banner_magic_standard_razor_standard	wh_main_bundle_anc_magic_standard_razor_standard
wh_main_banner_magic_standard_scarecrow_banner	wh_main_bundle_anc_magic_standard_scarecrow_banner
wh_main_banner_magic_standard_spider_banner	wh_main_bundle_anc_magic_standard_spider_banner
wh_main_banner_magic_standard_standard_of_discipline	wh_main_bundle_anc_magic_standard_standard_of_discipline
wh_main_banner_magic_standard_steel_standard	wh_main_bundle_anc_magic_standard_steel_standard
wh_main_banner_magic_standard_the_bad_moon_banner	wh_main_bundle_anc_magic_standard_the_bad_moon_banner
wh_main_banner_magic_standard_the_screaming_banner	wh_main_bundle_anc_magic_standard_the_screaming_banner
wh_main_banner_magic_standard_wailing_banner	wh_main_bundle_anc_magic_standard_wailing_banner
wh_main_banner_magic_standard_war_banner	wh_main_bundle_anc_magic_standard_war_banner
wh_main_banner_mark_of_chaos_mark_of_khorne	wh_main_bundle_anc_mark_of_chaos_mark_of_khorne
wh_main_banner_mark_of_chaos_mark_of_nurgle	wh_main_bundle_anc_mark_of_chaos_mark_of_nurgle
wh_main_banner_mark_of_chaos_mark_of_slaanesh	wh_main_bundle_anc_mark_of_chaos_mark_of_slaanesh
wh_main_banner_mark_of_chaos_mark_of_tzeentch	wh_main_bundle_anc_mark_of_chaos_mark_of_tzeentch
wh_main_banner_rune_ancestor_rune	wh_main_bundle_anc_rune_ancestor_rune
wh_main_banner_rune_master_rune_of_battle	wh_main_bundle_anc_rune_master_rune_of_battle
wh_main_banner_rune_master_rune_of_courage	wh_main_bundle_anc_rune_master_rune_of_courage
wh_main_banner_rune_master_rune_of_groth_one-eye	wh_main_bundle_anc_rune_master_rune_of_groth_one-eye
wh_main_banner_rune_master_rune_of_grungni	wh_main_bundle_anc_rune_master_rune_of_grungni
wh_main_banner_rune_master_rune_of_sanctuary	wh_main_bundle_anc_rune_master_rune_of_sanctuary
wh_main_banner_rune_master_rune_of_slowness	wh_main_bundle_anc_rune_master_rune_of_slowness
wh_main_banner_rune_master_rune_of_stoicism	wh_main_bundle_anc_rune_master_rune_of_stoicism
wh_main_banner_rune_master_rune_of_stromni_redbeard	wh_main_bundle_anc_rune_master_rune_of_stromni_redbeard
wh_main_banner_rune_master_rune_of_valaya	wh_main_bundle_anc_rune_master_rune_of_valaya
wh_main_banner_rune_strollaz_rune	wh_main_bundle_anc_rune_strollaz_rune
