key	text	tooltip
#Loc;1;text/db/effects_additional_tooltip_details__.loc		
effects_additional_tooltip_details_localised_description_building_upkeep	This amount will be deducted from your {{tr:treasury}} each turn while this building exists.	false
effects_additional_tooltip_details_localised_description_wh2_dlc09_effect_force_own_campaign_movement_range_province	{{tr:campaign_movement_range_additional_tooltip}}	false
effects_additional_tooltip_details_localised_description_wh2_dlc09_effect_replenishment_tmb_structures	{{tr:replenishment_additional_tooltip}}	false
effects_additional_tooltip_details_localised_description_wh2_dlc09_effect_replenishment_tmb_tomb_guard	{{tr:replenishment_additional_tooltip}}	false
effects_additional_tooltip_details_localised_description_wh2_dlc09_effect_replenishment_tomb_guard_chariots	{{tr:replenishment_additional_tooltip}}	false
effects_additional_tooltip_details_localised_description_wh2_dlc11_effect_agent_action_hinder_settlement_establish_pirate_cove_buff	[[col:yellow]]{{tr:agent_action_name_establish_pirate_cove}}[[/col]] (Target: Settlement)\\nEstablishes a Pirate Cove in the target settlement.	false
effects_additional_tooltip_details_localised_description_wh2_dlc11_effect_force_all_enemy_campaign_replenishment_rate	{{tr:replenishment_additional_tooltip}}	false
effects_additional_tooltip_details_localised_description_wh2_dlc11_effect_force_flagellants_campaign_replenishment_rate	{{tr:replenishment_additional_tooltip}}	false
effects_additional_tooltip_details_localised_description_wh2_dlc11_effect_force_slayer_campaign_replenishment_rate	{{tr:replenishment_additional_tooltip}}	false
effects_additional_tooltip_details_localised_description_wh2_dlc11_effect_unit_all_zombie_infantry_campaign_replenishment_rate	{{tr:replenishment_additional_tooltip}}	false
effects_additional_tooltip_details_localised_description_wh2_dlc12_effect_agent_action_enable_kroak_hinder_settlement_lord_kroak_colossal_deliverance	[[col:yellow]]{{tr:agent_action_name_colossal_deliverance}}[[/col]] (Target: Settlement)\\nDamages the walls of the target settlement.	false
effects_additional_tooltip_details_localised_description_wh2_dlc12_effect_agent_action_enable_kroak_hinder_settlement_lord_kroak_colossal_deliverance_cooldown_dummy	[[col:yellow]]{{tr:agent_action_name_colossal_deliverance}}[[/col]] (Target: Settlement)\\nDamages the walls of the target settlement.	false
effects_additional_tooltip_details_localised_description_wh2_dlc12_effect_agent_action_enable_kroak_hinder_settlement_lord_kroak_ultimate_deliverance	[[col:yellow]]{{tr:agent_action_name_ultimate_deliverance}}[[/col]] (Target: Settlement)\\nDamages the walls, buildings, and lowers the settlement level of the target settlement.	false
effects_additional_tooltip_details_localised_description_wh2_dlc12_effect_force_redcrested_skink_ark_of_sotek_campaign_replenishment_rate	{{tr:replenishment_additional_tooltip}}	false
effects_additional_tooltip_details_localised_description_wh2_dlc12_effect_force_terradon_ripperdactyl_campaign_replenishment_rate	{{tr:replenishment_additional_tooltip}}	false
effects_additional_tooltip_details_localised_description_wh2_dlc15_effect_replenishment_rate_goblins	{{tr:replenishment_additional_tooltip}}	false
effects_additional_tooltip_details_localised_description_wh2_dlc16_effect_ability_enable_spot_units_hiding_in_forest	Forest Spotting\\nEnemy units are unable to hide from this unit while in a forest.	false
effects_additional_tooltip_details_localised_description_wh2_dlc16_effect_agent_action_enable_wizard_hinder_settlement_ariel	[[col:yellow]]{{tr:agent_action_name_natures_wrath}}[[/col]] (Target: Settlement)\\nDamages the walls, buildings, and lowers the settlement level of the target settlement.	false
effects_additional_tooltip_details_localised_description_wh2_dlc16_effect_replenishment_dryads	{{tr:replenishment_additional_tooltip}}	false
effects_additional_tooltip_details_localised_description_wh2_dlc16_effect_replenishment_orcs	{{tr:replenishment_additional_tooltip}}	false
effects_additional_tooltip_details_localised_description_wh2_dlc16_effect_replenishment_tree_spirits	{{tr:replenishment_additional_tooltip}}	false
effects_additional_tooltip_details_localised_description_wh2_dlc16_skv_effect_force_replenishment_rate_moulder	{{tr:replenishment_additional_tooltip}}	false
effects_additional_tooltip_details_localised_description_wh2_dlc17_effect_agent_action_enable_runesmith_assist_army_harden_armour	[[col:yellow]]Harden Armour[[/col]] (Assist Army)\\nIncreases the armour of the parent army.	false
effects_additional_tooltip_details_localised_description_wh2_dlc17_effect_agent_action_enable_runesmith_assist_army_sharpen_weapons	[[col:yellow]]Sharpen Weapons[[/col]] (Assist Army)\\nIncreases the missile and melee damage of the parent army.	false
effects_additional_tooltip_details_localised_description_wh2_dlc17_effect_projectile_poison_daemonbane	"Daemonbane" projectiles become magical and anti-large, and will home in on targets	false
effects_additional_tooltip_details_localised_description_wh2_dlc17_effect_projectile_poison_fireblood	"Fireblood Toxin" projectiles explode on impact and reduce enemy armour	false
effects_additional_tooltip_details_localised_description_wh2_dlc17_effect_projectile_poison_slow_death	"Slow Death" projectiles will deal additional damage over time and extra damage to low-health units, and are particularly effective against single entities	false
effects_additional_tooltip_details_localised_description_wh2_dlc17_effect_projectile_poison_toadskin	"Toadskin Essence" projectiles will deal additional damage to infantry and reduce their morale	false
effects_additional_tooltip_details_localised_description_wh2_dlc17_effect_taurox_river_of_blood_bonus_dummy	"River of Blood" applies regional effects that decrease [[img:icon_morale]][[/img]]leadership for non-Chaos races, increase [[img:icon_morale]][[/img]]leadership for Chaos races, and increase [[img:icon_corruption_chs]][[/img]]Chaos corruption. Stacks up to three times.	false
effects_additional_tooltip_details_localised_description_wh2_dlc17_effect_taurox_river_of_blood_dummy	"River of Blood" applies regional effects that decrease [[img:icon_morale]][[/img]]leadership for non-Chaos races, increase [[img:icon_morale]][[/img]]leadership for Chaos races, and increase [[img:icon_corruption_chs]][[/img]]Chaos corruption. Stacks up to three times.	false
effects_additional_tooltip_details_localised_description_wh2_main_effect_agent_action_assist_army_increase_mobility_buff	[[col:yellow]]{{tr:agent_action_name_increase_mobility}}[[/col]] (Assist Army)\\nIncreases the campaign movement range of the parent army.	false
effects_additional_tooltip_details_localised_description_wh2_main_effect_agent_action_assist_army_replenish_troops_buff	[[col:yellow]]{{tr:agent_action_name_replenish_troops}}[[/col]] (Assist Army)\\nIncreases replenishment of the parent army.	false
effects_additional_tooltip_details_localised_description_wh2_main_effect_agent_action_assist_army_scavenge_buff	[[col:yellow]]{{tr:agent_action_name_scavenge}}[[/col]] (Assist Army)\\nIncreases the {{tr:icon_income}}income of post-battle loot earned by the parent army.	false
effects_additional_tooltip_details_localised_description_wh2_main_effect_agent_action_assist_army_scouting_buff	[[col:yellow]]{{tr:agent_action_name_scouting}}[[/col]] (Assist Army)\\nIncreases the parent army's chance of finding a magic item after winning a battle.	false
effects_additional_tooltip_details_localised_description_wh2_main_effect_agent_action_assist_army_training_buff	[[col:yellow]]{{tr:agent_action_name_training}}[[/col]] (Assist Army)\\nIncreases experience gain for units serving in the parent army.	false
effects_additional_tooltip_details_localised_description_wh2_main_effect_agent_action_hinder_agent_assassinate_buff	[[col:yellow]]{{tr:agent_action_name_assassinate}}[[/col]] (Target: Hero)\\nKills the target [[img:icon_hero]][[/img]]Hero.	false
effects_additional_tooltip_details_localised_description_wh2_main_effect_agent_action_hinder_agent_wound_buff	[[col:yellow]]{{tr:agent_action_name_wound}}[[/col]] (Target: Hero)\\nWounds the target [[img:icon_hero]][[/img]]Hero.	false
effects_additional_tooltip_details_localised_description_wh2_main_effect_agent_action_hinder_army_assault_unit_buff	[[col:yellow]]{{tr:agent_action_name_assault_unit}}[[/col]] (Target: Army)\\nInflicts damage upon a unit in the target army.	false
effects_additional_tooltip_details_localised_description_wh2_main_effect_agent_action_hinder_army_assault_units_buff	[[col:yellow]]{{tr:agent_action_name_assault_units}}[[/col]] (Target: Army)\\nInflicts damage upon all units in the target army.	false
effects_additional_tooltip_details_localised_description_wh2_main_effect_agent_action_hinder_army_block_army_buff	[[col:yellow]]{{tr:agent_action_name_block_army}}[[/col]] (Target: Army)\\nModifies the campaign movement range of the target army.	false
effects_additional_tooltip_details_localised_description_wh2_main_effect_agent_action_hinder_army_hinder_replenishment_buff	[[col:yellow]]{{tr:agent_action_name_hinder_replenishment}}[[/col]] (Target: Army)\\nModifies the replenishment of the target army.	false
effects_additional_tooltip_details_localised_description_wh2_main_effect_agent_action_hinder_settlement_assault_garrison_buff	[[col:yellow]]{{tr:agent_action_name_assault_garrison}}[[/col]] (Target: Settlement)\\nInflicts damage upon the garrison of the target settlement.	false
effects_additional_tooltip_details_localised_description_wh2_main_effect_agent_action_hinder_settlement_damage_building_buff	[[col:yellow]]{{tr:agent_action_name_damage_building}}[[/col]] (Target: Settlement)\\nInflicts damage upon a building in the target settlement.	false
effects_additional_tooltip_details_localised_description_wh2_main_effect_agent_action_hinder_settlement_damage_walls_buff	[[col:yellow]]{{tr:agent_action_name_damage_walls}}[[/col]] (Target: Settlement)\\nDamages the walls of the target settlement.	false
effects_additional_tooltip_details_localised_description_wh2_main_effect_agent_action_hinder_settlement_gain_influence_buff	[[col:yellow]]{{tr:agent_action_name_gain_influence}}[[/col]] (Target: Settlement)\\nGains [[img:icon_influence]][[/img]]influence.	false
effects_additional_tooltip_details_localised_description_wh2_main_effect_agent_action_hinder_settlement_steal_technology_buff	[[col:yellow]]{{tr:agent_action_name_steal_technology}}[[/col]] (Target: Settlement)\\nIncreases research rate for 3 turns.	false
effects_additional_tooltip_details_localised_description_wh2_main_effect_agent_action_passive_boost_income_buff	[[col:yellow]]{{tr:agent_action_name_boost_income}}[[/col]] (Constant Local Effect)\\nIncreases the income generated by buildings in the local province (reduces in enemy provinces).	false
effects_additional_tooltip_details_localised_description_wh2_main_effect_agent_action_passive_increase_slave_income_buff	[[col:yellow]]{{tr:agent_action_name_increase_slave_income}}[[/col]] (Constant Local Effect)\\nGenerates [[img:icon_slaves]][[/img]]slaves.	false
effects_additional_tooltip_details_localised_description_wh2_main_effect_agent_action_passive_increase_trade_buff	[[col:yellow]]{{tr:agent_action_name_increase_trade}}[[/col]] (Constant Local Effect)\\nIncreases tradable resources produced in the local province.	false
effects_additional_tooltip_details_localised_description_wh2_main_effect_agent_action_passive_spread_corruption_buff	[[col:yellow]]{{tr:agent_action_name_cleanse_corruption}}[[/col]] (Constant Local Effect)\\nReduces the amount of [[img:icon_corruption_untainted]][[/img]]corruption in the local province.	false
effects_additional_tooltip_details_localised_description_wh2_main_effect_agent_action_passive_spread_corruption_buff_chs	[[col:yellow]]{{tr:agent_action_name_spread_corruption}}[[/col]] (Constant Local Effect)\\nIncreases the amount of [[img:icon_corruption_chs]][[/img]]Chaos corruption in the local province.	false
effects_additional_tooltip_details_localised_description_wh2_main_effect_agent_action_passive_spread_corruption_buff_kho	[[col:yellow]]{{tr:agent_action_name_spread_corruption}}[[/col]] (Constant Local Effect)\\nIncreases the amount of [[img:icon_corruption_kho]][[/img]]Khorne corruption in the local province.	false
effects_additional_tooltip_details_localised_description_wh2_main_effect_agent_action_passive_spread_corruption_buff_nur	[[col:yellow]]{{tr:agent_action_name_spread_corruption}}[[/col]] (Constant Local Effect)\\nIncreases the amount of [[img:icon_corruption_nur][[/img]]Nurgle corruption in the local province.	false
effects_additional_tooltip_details_localised_description_wh2_main_effect_agent_action_passive_spread_corruption_buff_skv	[[col:yellow]]{{tr:agent_action_name_spread_corruption}}[[/col]] (Constant Local Effect)\\nIncreases the amount of [[img:icon_corruption_skv]][[/img]]Skaven corruption in the local province.	false
effects_additional_tooltip_details_localised_description_wh2_main_effect_agent_action_passive_spread_corruption_buff_sla	[[col:yellow]]{{tr:agent_action_name_spread_corruption}}[[/col]] (Constant Local Effect)\\nIncreases the amount of [[img:icon_corruption_sla]][[/img]]Slaanesh corruption in the local province.	false
effects_additional_tooltip_details_localised_description_wh2_main_effect_agent_action_passive_spread_corruption_buff_tze	[[col:yellow]]{{tr:agent_action_name_spread_corruption}}[[/col]] (Constant Local Effect)\\nIncreases the amount of [[img:icon_corruption_tze]][[/img]]Tzeentch corruption in the local province.	false
effects_additional_tooltip_details_localised_description_wh2_main_effect_agent_action_passive_spread_corruption_buff_vmp	[[col:yellow]]{{tr:agent_action_name_spread_corruption}}[[/col]] (Constant Local Effect)\\nIncreases the amount of [[img:icon_corruption_vmp]][[/img]]Vampiric corruption in the local province.	false
effects_additional_tooltip_details_localised_description_wh2_main_effect_agent_action_passive_spread_public_order_buff	[[col:yellow]]{{tr:agent_action_name_spread_public_order}}[[/col]] (Constant Local Effect)\\nIncreases {{tr:hp_campaign_public_order_term}} in the local province (reduces in enemy provinces).	false
effects_additional_tooltip_details_localised_description_wh2_main_effect_agent_action_passive_spread_public_order_horde_buff	[[col:yellow]]{{tr:agent_action_name_spread_public_order}}[[/col]] (Constant Local Effect)\\nReduces {{tr:hp_campaign_public_order_term}} in the local province.	false
effects_additional_tooltip_details_localised_description_wh2_main_effect_agent_action_passive_stimulate_growth_buff	[[col:yellow]]{{tr:agent_action_name_stimulate_growth}}[[/col]] (Constant Local Effect)\\nIncreases growth in the local province (reduces in enemy provinces).	false
effects_additional_tooltip_details_localised_description_wh2_main_effect_army_movement_up_dummy	{{tr:campaign_movement_range_additional_tooltip}}	false
effects_additional_tooltip_details_localised_description_wh2_main_effect_blark_soi_replenishment	{{tr:replenishment_additional_tooltip}}	false
effects_additional_tooltip_details_localised_description_wh2_main_effect_force_enemy_campaign_movement_range	{{tr:campaign_movement_range_additional_tooltip}}	false
effects_additional_tooltip_details_localised_description_wh2_main_effect_force_own_campaign_movement_range	{{tr:campaign_movement_range_additional_tooltip}}	false
effects_additional_tooltip_details_localised_description_wh2_main_effect_replenishment_lords	{{tr:replenishment_additional_tooltip}}	false
effects_additional_tooltip_details_localised_description_wh2_twa01_effect_enable_mount_spider_shrine	[[col:yellow]]Catchweb Spidershrine[[/col]]\\nThis mount provides decreased Winds of Magic costs for spells and cooldown reduction.	false
effects_additional_tooltip_details_localised_description_wh3_dlc20_effect_char_upgrade_xp_loss_mod_khorne_scripted	{{tr:path_to_glory_effect_extra_tooltip}}	false
effects_additional_tooltip_details_localised_description_wh3_dlc20_effect_char_upgrade_xp_loss_mod_nurgle_scripted	{{tr:path_to_glory_effect_extra_tooltip}}	false
effects_additional_tooltip_details_localised_description_wh3_dlc20_effect_char_upgrade_xp_loss_mod_slaanesh_scripted	{{tr:path_to_glory_effect_extra_tooltip}}	false
effects_additional_tooltip_details_localised_description_wh3_dlc20_effect_char_upgrade_xp_loss_mod_tzeentch_scripted	{{tr:path_to_glory_effect_extra_tooltip}}	false
effects_additional_tooltip_details_localised_description_wh3_dlc20_effect_character_ascension_mod_all_daemon_prince	{{tr:path_to_glory_effect_extra_tooltip}}	false
effects_additional_tooltip_details_localised_description_wh3_dlc20_effect_character_ascension_mod_kho_daemon_prince	{{tr:path_to_glory_effect_extra_tooltip}}	false
effects_additional_tooltip_details_localised_description_wh3_dlc20_effect_character_ascension_mod_nur_daemon_prince	{{tr:path_to_glory_effect_extra_tooltip}}	false
effects_additional_tooltip_details_localised_description_wh3_dlc20_effect_character_ascension_mod_sla_daemon_prince	{{tr:path_to_glory_effect_extra_tooltip}}	false
effects_additional_tooltip_details_localised_description_wh3_dlc20_effect_character_ascension_mod_tze_daemon_prince	{{tr:path_to_glory_effect_extra_tooltip}}	false
effects_additional_tooltip_details_localised_description_wh3_dlc20_effect_character_ascension_mod_und_daemon_prince	{{tr:path_to_glory_effect_extra_tooltip}}	false
effects_additional_tooltip_details_localised_description_wh3_dlc20_effect_chs_gift_cap_mod_all	{{tr:gift_effect_extra_tooltip}}	false
effects_additional_tooltip_details_localised_description_wh3_dlc20_effect_chs_gift_cap_mod_kho	{{tr:gift_effect_extra_tooltip}}	false
effects_additional_tooltip_details_localised_description_wh3_dlc20_effect_chs_gift_cap_mod_nur	{{tr:gift_effect_extra_tooltip}}	false
effects_additional_tooltip_details_localised_description_wh3_dlc20_effect_chs_gift_cap_mod_sla	{{tr:gift_effect_extra_tooltip}}	false
effects_additional_tooltip_details_localised_description_wh3_dlc20_effect_chs_gift_cap_mod_tze	{{tr:gift_effect_extra_tooltip}}	false
effects_additional_tooltip_details_localised_description_wh3_dlc20_effect_chs_gift_cap_mod_und	{{tr:gift_effect_extra_tooltip}}	false
effects_additional_tooltip_details_localised_description_wh3_dlc20_effect_chs_souls_on_plague_spread	{{tr:souls_effect_extra_tooltip}}	false
effects_additional_tooltip_details_localised_description_wh3_dlc20_effect_force_replenishment_rate_chaos_warhounds_all	{{tr:replenishment_additional_tooltip}}	false
effects_additional_tooltip_details_localised_description_wh3_dlc20_effect_force_replenishment_rate_khorne_marked_daemon_units	{{tr:replenishment_additional_tooltip}}	false
effects_additional_tooltip_details_localised_description_wh3_dlc20_effect_force_replenishment_rate_nurgle_marked_daemon_units	{{tr:replenishment_additional_tooltip}}	false
effects_additional_tooltip_details_localised_description_wh3_dlc20_effect_force_replenishment_rate_slaanesh_marked_daemon_units	{{tr:replenishment_additional_tooltip}}	false
effects_additional_tooltip_details_localised_description_wh3_dlc20_effect_force_replenishment_rate_tzeentch_marked_daemon_units	{{tr:replenishment_additional_tooltip}}	false
effects_additional_tooltip_details_localised_description_wh3_dlc20_effect_force_replenishment_rate_unmarked_units	{{tr:replenishment_additional_tooltip}}	false
effects_additional_tooltip_details_localised_description_wh3_dlc20_effect_initiative_cost_reduction_mark_of_khorne	{{tr:path_to_glory_effect_extra_tooltip}}	false
effects_additional_tooltip_details_localised_description_wh3_dlc20_effect_initiative_cost_reduction_mark_of_nurgle	{{tr:path_to_glory_effect_extra_tooltip}}	false
effects_additional_tooltip_details_localised_description_wh3_dlc20_effect_initiative_cost_reduction_mark_of_slaanesh	{{tr:path_to_glory_effect_extra_tooltip}}	false
effects_additional_tooltip_details_localised_description_wh3_dlc20_effect_initiative_cost_reduction_mark_of_tzeentch	{{tr:path_to_glory_effect_extra_tooltip}}	false
effects_additional_tooltip_details_localised_description_wh3_dlc20_effect_initiative_upgrade_all_kho_authority_dummy	{{tr:gift_effect_extra_tooltip}}	false
effects_additional_tooltip_details_localised_description_wh3_dlc20_effect_initiative_upgrade_all_kho_corruption_dummy	{{tr:gift_effect_extra_tooltip}}	false
effects_additional_tooltip_details_localised_description_wh3_dlc20_effect_initiative_upgrade_all_kho_diplomacy_dummy	{{tr:gift_effect_extra_tooltip}}	false
effects_additional_tooltip_details_localised_description_wh3_dlc20_effect_initiative_upgrade_all_kho_weapon_strength_dummy	{{tr:gift_effect_extra_tooltip}}	false
effects_additional_tooltip_details_localised_description_wh3_dlc20_effect_initiative_upgrade_all_nur_authority_dummy	{{tr:gift_effect_extra_tooltip}}	false
effects_additional_tooltip_details_localised_description_wh3_dlc20_effect_initiative_upgrade_all_nur_corruption_dummy	{{tr:gift_effect_extra_tooltip}}	false
effects_additional_tooltip_details_localised_description_wh3_dlc20_effect_initiative_upgrade_all_nur_diplomacy_dummy	{{tr:gift_effect_extra_tooltip}}	false
effects_additional_tooltip_details_localised_description_wh3_dlc20_effect_initiative_upgrade_all_nur_healing_dummy	{{tr:gift_effect_extra_tooltip}}	false
effects_additional_tooltip_details_localised_description_wh3_dlc20_effect_initiative_upgrade_all_sla_authority_dummy	{{tr:gift_effect_extra_tooltip}}	false
effects_additional_tooltip_details_localised_description_wh3_dlc20_effect_initiative_upgrade_all_sla_corruption_dummy	{{tr:gift_effect_extra_tooltip}}	false
effects_additional_tooltip_details_localised_description_wh3_dlc20_effect_initiative_upgrade_all_sla_diplomacy_dummy	{{tr:gift_effect_extra_tooltip}}	false
effects_additional_tooltip_details_localised_description_wh3_dlc20_effect_initiative_upgrade_all_sla_speed_dummy	{{tr:gift_effect_extra_tooltip}}	false
effects_additional_tooltip_details_localised_description_wh3_dlc20_effect_initiative_upgrade_all_tze_authority_dummy	{{tr:gift_effect_extra_tooltip}}	false
effects_additional_tooltip_details_localised_description_wh3_dlc20_effect_initiative_upgrade_all_tze_corruption_dummy	{{tr:gift_effect_extra_tooltip}}	false
effects_additional_tooltip_details_localised_description_wh3_dlc20_effect_initiative_upgrade_all_tze_diplomacy_dummy	{{tr:gift_effect_extra_tooltip}}	false
effects_additional_tooltip_details_localised_description_wh3_dlc20_effect_initiative_upgrade_all_tze_physical_resist_dummy	{{tr:gift_effect_extra_tooltip}}	false
effects_additional_tooltip_details_localised_description_wh3_dlc20_effect_initiative_upgrade_all_und_corruption_dummy	{{tr:gift_effect_extra_tooltip}}	false
effects_additional_tooltip_details_localised_description_wh3_dlc20_effect_initiative_upgrade_all_und_diplomacy_dummy	{{tr:gift_effect_extra_tooltip}}	false
effects_additional_tooltip_details_localised_description_wh3_dlc20_effect_pooled_resource_mod_chs_authority_khorne_character	{{tr:authority_effect_extra_tooltip}}	false
effects_additional_tooltip_details_localised_description_wh3_dlc20_effect_pooled_resource_mod_chs_authority_khorne_faction	{{tr:authority_effect_extra_tooltip}}	false
effects_additional_tooltip_details_localised_description_wh3_dlc20_effect_pooled_resource_mod_chs_authority_nurgle_character	{{tr:authority_effect_extra_tooltip}}	false
effects_additional_tooltip_details_localised_description_wh3_dlc20_effect_pooled_resource_mod_chs_authority_nurgle_faction	{{tr:authority_effect_extra_tooltip}}	false
effects_additional_tooltip_details_localised_description_wh3_dlc20_effect_pooled_resource_mod_chs_authority_slaanesh_character	{{tr:authority_effect_extra_tooltip}}	false
effects_additional_tooltip_details_localised_description_wh3_dlc20_effect_pooled_resource_mod_chs_authority_slaanesh_faction	{{tr:authority_effect_extra_tooltip}}	false
effects_additional_tooltip_details_localised_description_wh3_dlc20_effect_pooled_resource_mod_chs_authority_tzeentch_character	{{tr:authority_effect_extra_tooltip}}	false
effects_additional_tooltip_details_localised_description_wh3_dlc20_effect_pooled_resource_mod_chs_authority_tzeentch_faction	{{tr:authority_effect_extra_tooltip}}	false
effects_additional_tooltip_details_localised_description_wh3_dlc20_effect_pooled_resource_mod_chs_authority_undivided_character	{{tr:authority_effect_extra_tooltip}}	false
effects_additional_tooltip_details_localised_description_wh3_dlc20_effect_pooled_resource_mod_chs_authority_undivided_faction	{{tr:authority_effect_extra_tooltip}}	false
effects_additional_tooltip_details_localised_description_wh3_dlc20_effect_pooled_resource_mod_souls_battle	{{tr:souls_effect_extra_tooltip}}	false
effects_additional_tooltip_details_localised_description_wh3_dlc20_effect_replenishment_rate_marauder_horsemen_all	{{tr:replenishment_additional_tooltip}}	false
effects_additional_tooltip_details_localised_description_wh3_dlc20_effect_replenishment_rate_marauders_all	{{tr:replenishment_additional_tooltip}}	false
effects_additional_tooltip_details_localised_description_wh3_dlc20_effect_replenishment_und_all	{{tr:replenishment_additional_tooltip}}	false
effects_additional_tooltip_details_localised_description_wh3_dlc20_effect_souls_from_post_battle_options	{{tr:souls_effect_extra_tooltip}}	false
effects_additional_tooltip_details_localised_description_wh3_dlc20_effect_souls_received_from_own_casualties	{{tr:souls_effect_extra_tooltip}}	false
effects_additional_tooltip_details_localised_description_wh3_dlc23_agent_action_daemonsmith_sorcerer_hashuts_blood	[[col:yellow]]Blood of Hashut[[/col]] (Target: Settlement)\\nRazes the target settlement.	false
effects_additional_tooltip_details_localised_description_wh3_dlc23_effect_ability_replace_burning_bright_upgraded_chd_kdaai	Removes "Burning Bright"	false
effects_additional_tooltip_details_localised_description_wh3_dlc23_effect_contact_phase_chd_melee_infantry	[[col:red]]Armour: -30[[/col]]	false
effects_additional_tooltip_details_localised_description_wh3_dlc23_effect_contact_phase_suppressed_chd_missile_inf	[[col:red]]Speed: -30%[[/col]]	false
effects_additional_tooltip_details_localised_description_wh3_dlc23_effect_replenishment_rate_chd_arty_warmachines	{{tr:replenishment_additional_tooltip}}	false
effects_additional_tooltip_details_localised_description_wh3_dlc23_effect_replenishment_rate_hobgoblins	{{tr:replenishment_additional_tooltip}}	false
effects_additional_tooltip_details_localised_description_wh3_dlc24_effect_ability_ability_duration_debuff_spells_ostankya	This includes: \\n"{{tr:unit_abilities_onscreen_name_wh3_dlc24_spell_hags_the_forbidden_fens}}"\\n "{{tr:unit_abilities_onscreen_name_wh3_dlc24_spell_hags_curse_of_the_ancient_witch}}"\\n "{{tr:unit_abilities_onscreen_name_wh3_dlc24_spell_hags_malediction_of_madness}}"	false
effects_additional_tooltip_details_localised_description_wh3_dlc24_effect_ability_wom_cost_debuff_spells_ostankya	This includes: \\n"{{tr:unit_abilities_onscreen_name_wh3_dlc24_spell_hags_the_forbidden_fens}}"\\n "{{tr:unit_abilities_onscreen_name_wh3_dlc24_spell_hags_curse_of_the_ancient_witch}}"\\n "{{tr:unit_abilities_onscreen_name_wh3_dlc24_spell_hags_malediction_of_madness}}"	false
effects_additional_tooltip_details_localised_description_wh3_dlc24_effect_agent_action_assist_army_funnel_magic_buff	[[col:yellow]]{{tr:agent_action_name_funnel_magic}}[[/col]] (Assist Army)\\nAdds to the parent army's Winds of Magic power reserves each turn.	false
effects_additional_tooltip_details_localised_description_wh3_dlc24_effect_agent_action_assist_army_protective_charms_buff	[[col:yellow]]{{tr:agent_action_name_protective_charms}}[[/col]] (Assist Army)\\nReduces [[img:icon_attrition]][[/img]]attrition suffered by the parent army.	false
effects_additional_tooltip_details_localised_description_wh3_dlc24_effect_agent_action_hinder_army_hags_cursemark_buff	[[col:yellow]]{{tr:agent_action_name_hags_cursemark}}[[/col]] (Target: Army)\\nThe target army starts battles with Winded vigour for 3 turns.	false
effects_additional_tooltip_details_localised_description_wh3_dlc24_effect_agent_action_hinder_army_siphon_winds_buff	[[col:yellow]]{{tr:agent_action_name_siphon_winds}}[[/col]] (Target: Army)\\nReduces the target army's Winds of Magic reserves for 4 turns.	false
effects_additional_tooltip_details_localised_description_wh3_dlc24_effect_building_construction_cost_mod_all_compass	{{tr:wh3_dlc24_compass_effect_tooltip}}	false
effects_additional_tooltip_details_localised_description_wh3_dlc24_effect_building_construction_time_add_mod_all_compass	{{tr:wh3_dlc24_compass_effect_tooltip}}	false
effects_additional_tooltip_details_localised_description_wh3_dlc24_effect_building_settlement_initial_supply_points_compass	{{tr:wh3_dlc24_compass_effect_tooltip}}	false
effects_additional_tooltip_details_localised_description_wh3_dlc24_effect_character_campaign_experience_mod_compass	{{tr:wh3_dlc24_compass_effect_tooltip}}	false
effects_additional_tooltip_details_localised_description_wh3_dlc24_effect_cth_force_subtype_campaign_movement_yin	{{tr:campaign_movement_range_additional_tooltip}}	false
effects_additional_tooltip_details_localised_description_wh3_dlc24_effect_force_all_campaign_experience_base_all_compass	{{tr:wh3_dlc24_compass_effect_tooltip}}	false
effects_additional_tooltip_details_localised_description_wh3_dlc24_effect_force_stat_missile_resistance_cth_jade_warrior	Missile Resistance. Damage of missile attacks is reduced by this amount, up to a maximum of 90%	false
effects_additional_tooltip_details_localised_description_wh3_dlc24_effect_force_stat_missile_resistance_terracotta_sentinel	Missile Resistance. Damage of missile attacks is reduced by this amount, up to a maximum of 90%	false
effects_additional_tooltip_details_localised_description_wh3_dlc24_effect_force_stat_ward_save_cth_infantry	Ward Save. Any type of damage is reduced by this amount, up to a maximum of 90%	false
effects_additional_tooltip_details_localised_description_wh3_dlc24_effect_public_order_compass	{{tr:wh3_dlc24_compass_effect_tooltip}}	false
effects_additional_tooltip_details_localised_description_wh3_dlc24_effect_tze_cotw_enable_force_peace	Force peace between two factions.	false
effects_additional_tooltip_details_localised_description_wh3_dlc24_effect_winds_of_magic_compass	{{tr:wh3_dlc24_compass_effect_tooltip}}	false
effects_additional_tooltip_details_localised_description_wh3_dlc24_effect_xp_gain_all_units_compass	{{tr:wh3_dlc24_compass_effect_tooltip}}	false
effects_additional_tooltip_details_localised_description_wh3_dlc24_tech_ksl_ostankya_witches_hut_hex_upgrade_1	Stops the target army from moving entirely	false
effects_additional_tooltip_details_localised_description_wh3_dlc24_tech_ksl_ostankya_witches_hut_hex_upgrade_2	Teleports any target army to the chosen Magical Forest	false
effects_additional_tooltip_details_localised_description_wh3_dlc24_tech_ksl_ostankya_witches_hut_hex_upgrade_3	Armies summoned every other turn will be stronger	false
effects_additional_tooltip_details_localised_description_wh3_dlc24_tech_ksl_ostankya_witches_hut_hex_upgrade_4	The target settlement's entire province income will be provided	false
effects_additional_tooltip_details_localised_description_wh3_dlc24_tech_ksl_ostankya_witches_hut_hex_upgrade_5	The target settlement's province will not gain any additional corruption for the duration	false
effects_additional_tooltip_details_localised_description_wh3_dlc25_effect_agent_nur_cultist_campaign_movement_increase	{{tr:campaign_movement_range_additional_tooltip}}	false
effects_additional_tooltip_details_localised_description_wh3_dlc25_effect_contact_phase_suppressed_dwf_organ_guns	[[col:red]]Speed: -30%[[/col]]	false
effects_additional_tooltip_details_localised_description_wh3_main_effect_agent_movement_range_mod_kho_bloodreaper	{{tr:campaign_movement_range_additional_tooltip}}	false
effects_additional_tooltip_details_localised_description_wh3_main_effect_army_ability_enable_celestial_intervention	{{tr:wh3_dlc24_compass_effect_tooltip}}	false
effects_additional_tooltip_details_localised_description_wh3_main_effect_corruption_reduction_compass	{{tr:wh3_dlc24_compass_effect_tooltip}}	false
effects_additional_tooltip_details_localised_description_wh3_main_effect_cth_force_subtype_campaign_movement_yang	{{tr:campaign_movement_range_additional_tooltip}}	false
effects_additional_tooltip_details_localised_description_wh3_main_effect_enable_ritual_ksl_winter_dazh_upgraded	Increases [[img:icon_income]][[/img]]income from all buildings and trade and adds "The Land Awakened" army ability.	false
effects_additional_tooltip_details_localised_description_wh3_main_effect_enable_ritual_ksl_winter_salyak_upgraded	Increases [[img:icon_replenishment]][[/img]]casualty replenishment rate, [[img:icon_growth]][[/img]]growth and [[img:icon_public_order]][[/img]]control of all provinces.	false
effects_additional_tooltip_details_localised_description_wh3_main_effect_enable_ritual_ksl_winter_tor_upgraded	Increases [[img:icon_melee_attack]][[/img]]melee attack of all units.	false
effects_additional_tooltip_details_localised_description_wh3_main_effect_enable_ritual_ksl_winter_ursun_upgraded	Increases [[img:icon_melee_defence]][[/img]]melee defence of all armies.	false
effects_additional_tooltip_details_localised_description_wh3_main_effect_force_replenishment_rate_cth_peasant_units	{{tr:replenishment_additional_tooltip}}	false
effects_additional_tooltip_details_localised_description_wh3_main_effect_force_replenishment_rate_cth_terracotta_sentinels	{{tr:replenishment_additional_tooltip}}	false
effects_additional_tooltip_details_localised_description_wh3_main_effect_force_replenishment_rate_kho_bloodletters_exalted_bloodletters	{{tr:replenishment_additional_tooltip}}	false
effects_additional_tooltip_details_localised_description_wh3_main_effect_force_replenishment_rate_khorne	{{tr:replenishment_additional_tooltip}}	false
effects_additional_tooltip_details_localised_description_wh3_main_effect_force_replenishment_rate_ksl_elemental	{{tr:replenishment_additional_tooltip}}	false
effects_additional_tooltip_details_localised_description_wh3_main_effect_force_replenishment_rate_nur_nurglings	{{tr:replenishment_additional_tooltip}}	false
effects_additional_tooltip_details_localised_description_wh3_main_effect_force_replenishment_rate_nur_plague_drones_rot_flies	{{tr:replenishment_additional_tooltip}}	false
effects_additional_tooltip_details_localised_description_wh3_main_effect_force_replenishment_rate_nurgle	{{tr:replenishment_additional_tooltip}}	false
effects_additional_tooltip_details_localised_description_wh3_main_effect_force_replenishment_rate_ogr_gorgers	{{tr:replenishment_additional_tooltip}}	false
effects_additional_tooltip_details_localised_description_wh3_main_effect_force_replenishment_rate_sla_marauders_hellstriders	{{tr:replenishment_additional_tooltip}}	false
effects_additional_tooltip_details_localised_description_wh3_main_effect_force_replenishment_rate_slaanesh	{{tr:replenishment_additional_tooltip}}	false
effects_additional_tooltip_details_localised_description_wh3_main_effect_force_replenishment_rate_tze_forsaken	{{tr:replenishment_additional_tooltip}}	false
effects_additional_tooltip_details_localised_description_wh3_main_effect_force_replenishment_rate_tzeentch	{{tr:replenishment_additional_tooltip}}	false
effects_additional_tooltip_details_localised_description_wh3_main_effect_kairos_unlock_item_lore_of_beasts_dummy	Fragments can be equipped by Kairos in the Character Details panel to swap some spells from the Lore of Tzeentch for spells from other Lores of Magic. Only one Fragment may be equipped at a time.	false
effects_additional_tooltip_details_localised_description_wh3_main_effect_kairos_unlock_item_lore_of_death_dummy	Fragments can be equipped by Kairos in the Character Details panel to swap some spells from the Lore of Tzeentch for spells from other Lores of Magic. Only one Fragment may be equipped at a time.	false
effects_additional_tooltip_details_localised_description_wh3_main_effect_kairos_unlock_item_lore_of_fire_dummy	Fragments can be equipped by Kairos in the Character Details panel to swap some spells from the Lore of Tzeentch for spells from other Lores of Magic. Only one Fragment may be equipped at a time.	false
effects_additional_tooltip_details_localised_description_wh3_main_effect_kairos_unlock_item_lore_of_heavens_dummy	Fragments can be equipped by Kairos in the Character Details panel to swap some spells from the Lore of Tzeentch for spells from other Lores of Magic. Only one Fragment may be equipped at a time.	false
effects_additional_tooltip_details_localised_description_wh3_main_effect_kairos_unlock_item_lore_of_light_dummy	Fragments can be equipped by Kairos in the Character Details panel to swap some spells from the Lore of Tzeentch for spells from other Lores of Magic. Only one Fragment may be equipped at a time.	false
effects_additional_tooltip_details_localised_description_wh3_main_effect_kairos_unlock_item_lore_of_metal_dummy	Fragments can be equipped by Kairos in the Character Details panel to swap some spells from the Lore of Tzeentch for spells from other Lores of Magic. Only one Fragment may be equipped at a time.	false
effects_additional_tooltip_details_localised_description_wh3_main_effect_kairos_unlock_item_lore_of_shadows_dummy	Fragments can be equipped by Kairos in the Character Details panel to swap some spells from the Lore of Tzeentch for spells from other Lores of Magic. Only one Fragment may be equipped at a time.	false
effects_additional_tooltip_details_localised_description_wh3_main_effect_kho_spawned_armies_battle_speed_mod	{{tr:wh3_main_kho_spawned_armies}}	false
effects_additional_tooltip_details_localised_description_wh3_main_effect_kho_spawned_armies_guaranteed_bloodthirster	{{tr:wh3_main_kho_spawned_armies}}	false
effects_additional_tooltip_details_localised_description_wh3_main_effect_kho_spawned_armies_initial_immunity_mod	{{tr:wh3_main_kho_spawned_armies}}	false
effects_additional_tooltip_details_localised_description_wh3_main_effect_kho_spawned_armies_melee_attack_mod	{{tr:wh3_main_kho_spawned_armies}}	false
effects_additional_tooltip_details_localised_description_wh3_main_effect_kho_spawned_armies_movement_mod	{{tr:wh3_main_kho_spawned_armies}}	false
effects_additional_tooltip_details_localised_description_wh3_main_effect_kho_spawned_armies_post_battle_immunity_mod	{{tr:wh3_main_kho_spawned_armies}}	false
effects_additional_tooltip_details_localised_description_wh3_main_effect_kho_spawned_armies_size_mod	{{tr:wh3_main_kho_spawned_armies}}	false
effects_additional_tooltip_details_localised_description_wh3_main_effect_kho_spawned_army_upkeep	{{tr:wh3_main_kho_spawned_armies}}	false
effects_additional_tooltip_details_localised_description_wh3_main_effect_province_growth_compass	{{tr:wh3_dlc24_compass_effect_tooltip}}	false
effects_additional_tooltip_details_localised_description_wh3_main_effect_public_order_compass	{{tr:wh3_dlc24_compass_effect_tooltip}}	false
effects_additional_tooltip_details_localised_description_wh3_main_effect_stance_ap_percentage_increase	{{tr:campaign_movement_range_additional_tooltip}}	false
effects_additional_tooltip_details_localised_description_wh3_main_effect_tze_cotw_enable_borrow_time	Restore an army's movement range.	false
effects_additional_tooltip_details_localised_description_wh3_main_effect_tze_cotw_enable_break_alliance	Break the [[img:icon_military_alliance]][[/img]]military or [[img:icon_defensive_alliance]][[/img]]defence alliance between two factions.	false
effects_additional_tooltip_details_localised_description_wh3_main_effect_tze_cotw_enable_force_rebellion	Force a rebellion in the region.	false
effects_additional_tooltip_details_localised_description_wh3_main_effect_tze_cotw_enable_force_war	Force a war between two factions.	false
effects_additional_tooltip_details_localised_description_wh3_main_effect_tze_cotw_enable_give_war_coordination_target	Give an offensive war co-ordination target to a faction.	false
effects_additional_tooltip_details_localised_description_wh3_main_effect_tze_cotw_enable_halt_army	Halt an army for a turn.	false
effects_additional_tooltip_details_localised_description_wh3_main_effect_tze_cotw_enable_open_gates	Open the gates of a settlement with walls.	false
effects_additional_tooltip_details_localised_description_wh3_main_effect_tze_cotw_enable_reveal_shroud	Reveal the shroud over all of a faction's territory.	false
effects_additional_tooltip_details_localised_description_wh3_main_effect_tze_cotw_enable_track_army	Track and transfer an army's line of sight.	false
effects_additional_tooltip_details_localised_description_wh3_main_effect_tze_cotw_enable_transfer_settlement	Transfer a settlement from one faction to another.	false
effects_additional_tooltip_details_localised_description_wh3_main_effect_unit_enable_spell_mastery_tzeentch_chars	Mastery of the Elemental Winds. When more than one unit that share this attribute are in the same army, the power of spells cast is increased.	false
effects_additional_tooltip_details_localised_description_wh3_main_effect_winds_of_magic_compass_increase	{{tr:wh3_dlc24_compass_effect_tooltip}}	false
effects_additional_tooltip_details_localised_description_wh_dlc06_effect_replenishment_savage_orcs	{{tr:replenishment_additional_tooltip}}	false
effects_additional_tooltip_details_localised_description_wh_dlc07_effect_force_all_campaign_replenishment_rate_peasants	{{tr:replenishment_additional_tooltip}}	false
effects_additional_tooltip_details_localised_description_wh_dlc08_effect_foce_slayers_replenishment_rate	{{tr:replenishment_additional_tooltip}}	false
effects_additional_tooltip_details_localised_description_wh_main_effect_agent_movement_range_mod	{{tr:campaign_movement_range_additional_tooltip}}	false
effects_additional_tooltip_details_localised_description_wh_main_effect_character_stat_aura_leadership_effect	Aura. Any unit standing within this character's aura in battle will receive a [[img:icon_morale]][[/img]]leadership bonus.	false
effects_additional_tooltip_details_localised_description_wh_main_effect_character_stat_fire_resistance	Fire Resistance. Damage of [[img:ui/skins/default/modifier_icon_flaming.png]][[/img]]flaming attacks is reduced by this amount, up to a maximum of 90%	false
effects_additional_tooltip_details_localised_description_wh_main_effect_character_stat_leadership_aura_size	Aura. Any unit standing within this character's aura in battle will receive a [[img:icon_morale]][[/img]]leadership bonus.	false
effects_additional_tooltip_details_localised_description_wh_main_effect_character_stat_leadership_aura_size_attacking	Aura. Any unit standing within this character's aura in battle will receive a [[img:icon_morale]][[/img]]leadership bonus.	false
effects_additional_tooltip_details_localised_description_wh_main_effect_character_stat_leadership_aura_size_defending	Aura. Any unit standing within this character's aura in battle will receive a [[img:icon_morale]][[/img]]leadership bonus.	false
effects_additional_tooltip_details_localised_description_wh_main_effect_character_stat_leadership_aura_size_sieging	Aura. Any unit standing within this character's aura in battle will receive a [[img:icon_morale]][[/img]]leadership bonus.	false
effects_additional_tooltip_details_localised_description_wh_main_effect_character_stat_magic_resistance	Spell Resistance. Damage of [[img:ui/skins/default/modifier_icon_magical.png]][[/img]]spells and magical abilities is reduced by this amount, up to a maximum of 90%	false
effects_additional_tooltip_details_localised_description_wh_main_effect_character_stat_missile_resistance	Missile Resistance. Damage of missile attacks is reduced by this amount, up to a maximum of 90%	false
effects_additional_tooltip_details_localised_description_wh_main_effect_character_stat_physical_resistance	Physical Resistance. Damage of non-magical attacks is reduced by this amount, up to a maximum of 90%	false
effects_additional_tooltip_details_localised_description_wh_main_effect_character_stat_ward_save	Ward Save. Any type of damage is reduced by this amount, up to a maximum of 90%	false
effects_additional_tooltip_details_localised_description_wh_main_effect_conquest_enable_night_battles	The option to carry out a lightning strike battle will appear on the Pre-Battle panel. Enabling this prevents reinforcements from joining the battle but will cause your troops to start the battle with reduced Vigour.	false
effects_additional_tooltip_details_localised_description_wh_main_effect_economy_gdp_mod_all_compass	{{tr:wh3_dlc24_compass_effect_tooltip}}	false
effects_additional_tooltip_details_localised_description_wh_main_effect_force_all_campaign_movement_range	{{tr:campaign_movement_range_additional_tooltip}}	false
effects_additional_tooltip_details_localised_description_wh_main_effect_force_all_campaign_movement_range_bad	{{tr:campaign_movement_range_additional_tooltip}}	false
effects_additional_tooltip_details_localised_description_wh_main_effect_force_all_campaign_recruitment_cost_all_compass	{{tr:wh3_dlc24_compass_effect_tooltip}}	false
effects_additional_tooltip_details_localised_description_wh_main_effect_force_all_campaign_replenishment_rate	{{tr:replenishment_additional_tooltip}}	false
effects_additional_tooltip_details_localised_description_wh_main_effect_force_all_campaign_replenishment_rate_chaos	{{tr:replenishment_additional_tooltip}}	false
effects_additional_tooltip_details_localised_description_wh_main_effect_force_all_campaign_replenishment_rate_chaos_good	{{tr:replenishment_additional_tooltip}}	false
effects_additional_tooltip_details_localised_description_wh_main_effect_force_all_campaign_replenishment_rate_compass	{{tr:wh3_dlc24_compass_effect_tooltip}}	false
effects_additional_tooltip_details_localised_description_wh_main_effect_force_all_campaign_replenishment_rate_undead	{{tr:replenishment_additional_tooltip}}	false
effects_additional_tooltip_details_localised_description_wh_main_effect_force_all_campaign_replenishment_rate_undead_good	{{tr:replenishment_additional_tooltip}}	false
effects_additional_tooltip_details_localised_description_wh_main_effect_force_army_campaign_movement_range	{{tr:campaign_movement_range_additional_tooltip}}	false
effects_additional_tooltip_details_localised_description_wh_main_effect_force_artillery_campaign_replenishment_rate	{{tr:replenishment_additional_tooltip}}	false
effects_additional_tooltip_details_localised_description_wh_main_effect_force_knights_campaign_replenishment_rate	{{tr:replenishment_additional_tooltip}}	false
effects_additional_tooltip_details_localised_description_wh_main_effect_force_stat_fire_resistance	Fire Resistance. Damage of [[img:ui/skins/default/modifier_icon_flaming.png]][[/img]]flaming attacks is reduced by this amount, up to a maximum of 90%	false
effects_additional_tooltip_details_localised_description_wh_main_effect_force_stat_leadership_enemy_unit_compass	{{tr:wh3_dlc24_compass_effect_tooltip}}	false
effects_additional_tooltip_details_localised_description_wh_main_effect_force_stat_magic_resistance	Spell Resistance. Damage of [[img:ui/skins/default/modifier_icon_magical.png]][[/img]]spells and magical abilities is reduced by this amount, up to a maximum of 90%	false
effects_additional_tooltip_details_localised_description_wh_main_effect_force_stat_missile_resistance_artillery	Missile Resistance. Damage of missile attacks is reduced by this amount, up to a maximum of 90%	false
effects_additional_tooltip_details_localised_description_wh_main_effect_force_stat_physical_resistance	Physical Resistance. Damage of non-magical attacks is reduced by this amount, up to a maximum of 90%	false
effects_additional_tooltip_details_localised_description_wh_main_effect_force_stat_ward_save	Ward Save. Any type of damage is reduced by this amount, up to a maximum of 90%	false
effects_additional_tooltip_details_localised_description_wh_main_effect_general_aura_mod_all_during_ambush	Aura. Any unit standing within this character's aura in battle will receive a [[img:icon_morale]][[/img]]leadership bonus.	false
