key	text	tooltip
#Loc;1;text/db/random_localisation_strings__.loc		
random_localisation_strings_string_AP	- AP	false
random_localisation_strings_string_April	text_rejected	false
random_localisation_strings_string_August	text_rejected	false
random_localisation_strings_string_CAMPAIGN_POLITICS_ACTION_TYPE_ADOPT	Adopt	false
random_localisation_strings_string_CAMPAIGN_POLITICS_ACTION_TYPE_ASSASSINATE	Assassinate	false
random_localisation_strings_string_CAMPAIGN_POLITICS_ACTION_TYPE_ASSASSINATE_WIFE	Assassinate Wife	false
random_localisation_strings_string_CAMPAIGN_POLITICS_ACTION_TYPE_BRIBE	Bribe	false
random_localisation_strings_string_CAMPAIGN_POLITICS_ACTION_TYPE_DIVORCE	Divorce	false
random_localisation_strings_string_CAMPAIGN_POLITICS_ACTION_TYPE_GET_INTO_POSITION	Secure Promotion	false
random_localisation_strings_string_CAMPAIGN_POLITICS_ACTION_TYPE_MARRIAGE	Marriage	false
random_localisation_strings_string_CAMPAIGN_POLITICS_ACTION_TYPE_SPREAD_RUMOURS	Spread Rumours	false
random_localisation_strings_string_CARD_STAT_BEST_1V1_LADDER_PLACEMENT_NAVAL	Best ladder placement 1v1 naval	false
random_localisation_strings_string_CARD_STAT_BEST_1V1_SKILL_NAVAL	Best all-time skill rating 1v1 naval	false
random_localisation_strings_string_CARD_STAT_BEST_2V2_LADDER_PLACEMENT_NAVAL	Best ladder placement 2v2 naval	false
random_localisation_strings_string_CARD_STAT_BEST_2V2_SKILL_NAVAL	Best all-time skill rating 2v2 naval	false
random_localisation_strings_string_CARD_STAT_BEST_3V3_LADDER_PLACEMENT_NAVAL	Best ladder placement 3v3 naval	false
random_localisation_strings_string_CARD_STAT_BEST_3V3_SKILL_NAVAL	Best all-time skill rating 3v3 naval	false
random_localisation_strings_string_CARD_STAT_BEST_4V4_LADDER_PLACEMENT_NAVAL	Best ladder placement 4v4 naval	false
random_localisation_strings_string_CARD_STAT_BEST_4V4_SKILL_NAVAL	Best all-time skill rating 4v4 naval	false
random_localisation_strings_string_Cancelled	Cancelled	false
random_localisation_strings_string_Cannot_reinforce_artillery	Siege weapons cannot join the battle as reinforcements	false
random_localisation_strings_string_CapturePoint	Capture Point Battle	false
random_localisation_strings_string_Children	Children:	false
random_localisation_strings_string_Classic	Land Battle	false
random_localisation_strings_string_Completed	Completed	false
random_localisation_strings_string_Construction_site	Construction Site	false
random_localisation_strings_string_DX11	DX11	false
random_localisation_strings_string_DX12	DX12 (BETA)	false
random_localisation_strings_string_December	text_rejected	false
random_localisation_strings_string_Empty_building	Construction slot||You can construct new buildings here.	false
random_localisation_strings_string_Empty_building_warning	\\n\\nIf you leave this site undeveloped for too long, slums will appear.	false
random_localisation_strings_string_FACTION_FOOD_FACTOR_ARMIES	Units	false
random_localisation_strings_string_FACTION_FOOD_FACTOR_BASE_FOOD	Base Food	false
random_localisation_strings_string_FACTION_FOOD_FACTOR_BUILDINGS	Settlements	false
random_localisation_strings_string_FACTION_FOOD_FACTOR_CHARACTERS	Characters	false
random_localisation_strings_string_FACTION_FOOD_FACTOR_EDICTS	Edicts	false
random_localisation_strings_string_FACTION_FOOD_FACTOR_EVENTS	Events	false
random_localisation_strings_string_FACTION_FOOD_FACTOR_FERTILITY	Fertility	false
random_localisation_strings_string_FACTION_FOOD_FACTOR_HORDES	Hordes	false
random_localisation_strings_string_FACTION_FOOD_FACTOR_PENDING_CONSTRUCTION	Settlements	false
random_localisation_strings_string_FACTION_FOOD_FACTOR_PENDING_RECRUITMENT	Units	false
random_localisation_strings_string_FACTION_FOOD_FACTOR_PENDING_RESEARCH	Technologies	false
random_localisation_strings_string_FACTION_FOOD_FACTOR_RAIDING	Raiding	false
random_localisation_strings_string_FACTION_FOOD_FACTOR_RECENT_BATTLES	Recent Battles	false
random_localisation_strings_string_FACTION_FOOD_FACTOR_TECHNOLOGIES	Technology	false
random_localisation_strings_string_FACTION_PROVINCE_FOOD_FACTOR_ARMIES	Units	false
random_localisation_strings_string_FACTION_PROVINCE_FOOD_FACTOR_BASE_FOOD	Base food	false
random_localisation_strings_string_FACTION_PROVINCE_FOOD_FACTOR_BUILDINGS_IN_REGIONS	Settlements	false
random_localisation_strings_string_FACTION_PROVINCE_FOOD_FACTOR_CHARACTERS	Characters	false
random_localisation_strings_string_FACTION_PROVINCE_FOOD_FACTOR_EDICTS	Edicts	false
random_localisation_strings_string_FACTION_PROVINCE_FOOD_FACTOR_EVENTS	Province Events	false
random_localisation_strings_string_FACTION_PROVINCE_FOOD_FACTOR_EVENTS_IN_REGIONS	Region Events	false
random_localisation_strings_string_FACTION_PROVINCE_FOOD_FACTOR_FERTILITY	Fertility	false
random_localisation_strings_string_FACTION_PROVINCE_FOOD_FACTOR_HORDES	Hordes	false
random_localisation_strings_string_FACTION_PROVINCE_FOOD_FACTOR_PENDING_CONSTRUCTION_IN_REGIONS	Settlements	false
random_localisation_strings_string_FACTION_PROVINCE_FOOD_FACTOR_PENDING_RECRUITMENT	Units	false
random_localisation_strings_string_FACTION_PROVINCE_FOOD_FACTOR_RAIDING	Raiding	false
random_localisation_strings_string_FACTION_PROVINCE_FOOD_FACTOR_RECENT_BATTLES	Recent Battles	false
random_localisation_strings_string_FACTION_PROVINCE_FOOD_FACTOR_TECHNOLOGIES	Technology	false
random_localisation_strings_string_Failed	Failed	false
random_localisation_strings_string_Feature_unavailable	Unavailable in this campaign	false
random_localisation_strings_string_February	text_rejected	false
random_localisation_strings_string_Historic	Historic Battle	false
random_localisation_strings_string_January	text_rejected	false
random_localisation_strings_string_July	text_rejected	false
random_localisation_strings_string_June	text_rejected	false
random_localisation_strings_string_MILITARY_FORCE_FOOD_FACTOR_BASE_FOOD	Base Food	false
random_localisation_strings_string_MILITARY_FORCE_FOOD_FACTOR_BUILDINGS	Settlements	false
random_localisation_strings_string_MILITARY_FORCE_FOOD_FACTOR_CHARACTERS	Characters	false
random_localisation_strings_string_MILITARY_FORCE_FOOD_FACTOR_EVENTS	Events	false
random_localisation_strings_string_MILITARY_FORCE_FOOD_FACTOR_FERTILITY	Fertility	false
random_localisation_strings_string_MILITARY_FORCE_FOOD_FACTOR_PENDING_CONSTRUCTION	Horde Buildings	false
random_localisation_strings_string_MILITARY_FORCE_FOOD_FACTOR_PENDING_RECRUITMENT	Horde Armies	false
random_localisation_strings_string_MILITARY_FORCE_FOOD_FACTOR_RAIDING	Raiding	false
random_localisation_strings_string_MILITARY_FORCE_FOOD_FACTOR_STANCE	Stance	false
random_localisation_strings_string_MILITARY_FORCE_FOOD_FACTOR_TECHNOLOGIES	Technology	false
random_localisation_strings_string_MILITARY_FORCE_FOOD_FACTOR_UNITS	Units	false
random_localisation_strings_string_March	text_rejected	false
random_localisation_strings_string_Married	text_rejected	false
random_localisation_strings_string_May	text_rejected	false
random_localisation_strings_string_Middle	text_rejected	false
random_localisation_strings_string_Naval	Naval Battle	false
random_localisation_strings_string_November	text_rejected	false
random_localisation_strings_string_October	text_rejected	false
random_localisation_strings_string_REGION_FOOD_FACTOR_BASE_FOOD	Base Food	false
random_localisation_strings_string_REGION_FOOD_FACTOR_BUILDINGS	Settlements	false
random_localisation_strings_string_REGION_FOOD_FACTOR_EVENTS	Events	false
random_localisation_strings_string_REGION_FOOD_FACTOR_FERTILITY	Fertility	false
random_localisation_strings_string_REGION_FOOD_FACTOR_HORDES	Hordes	false
random_localisation_strings_string_REGION_FOOD_FACTOR_PENDING_CONSTRUCTION	Settlements	false
random_localisation_strings_string_REGION_FOOD_FACTOR_RAIDING	Raiding	false
random_localisation_strings_string_REGION_FOOD_FACTOR_RECENT_BATTLE	Recent Battles	false
random_localisation_strings_string_REGION_FOOD_FACTOR_TECHNOLOGIES	Technology	false
random_localisation_strings_string_Recruit_Travel_Turns	Recruitment turns||The left-hand number shows the number of turns needed to recruit this unit.||The right-hand number shows the number of turns this unit takes to reach its recruiting Lord.||Lords can recruit units in the field. Recruited units are transported directly to his location.	false
random_localisation_strings_string_Scupper	Scupper||Scupper unused ships to save upkeep costs. 	false
random_localisation_strings_string_September	September	false
random_localisation_strings_string_Ship_is_suffering_attrition	This ship is suffering attrition as it is on the high seas. Move the ship outside of the attritional area to prevent this from happening.	false
random_localisation_strings_string_Siege	Siege Battle	false
random_localisation_strings_string_Single	Single	false
random_localisation_strings_string_StratHudButton_Cannot_Demolish0	[[col:red]]You cannot afford to demolish this building.[[/col]]	false
random_localisation_strings_string_StratHudButton_Cannot_Demolish1	[[col:red]]You cannot demolish settlements and ports, roads, or speciality buildings at their base levels.[[/col]]	false
random_localisation_strings_string_StratHudButton_Cannot_Recruit_Unit11	No recruitment points available	false
random_localisation_strings_string_StratHud_Building_Card_Recruit_Queued	Left-click to remove this building from the queue, right-click for further information.	false
random_localisation_strings_string_StratHud_Building_Card_Recruit_Queued_Building_Browser	Left-click to remove this building from the queue.	false
random_localisation_strings_string_StratHud_Building_Card_Recruit_Selection	Left-click to construct this building, right-click for further information.	false
random_localisation_strings_string_StratHud_Building_Card_Recruit_Selection_No_Info	Left-click to construct this building.	false
random_localisation_strings_string_StratHud_Unit_Card_Recruit_Queued	Left-click to remove unit from queue, right-click for further information.	false
random_localisation_strings_string_StratHud_Unit_Card_Recruit_Selection	Left-click to recruit this unit, right-click for further information.	false
random_localisation_strings_string_StratHud_Unit_Card_Recruit_Selection_No_Info	Left-click to recruit this unit	false
random_localisation_strings_string_StratHudbutton_Cannot_Build0	[[col:red]]Cannot build[[/col]]	false
random_localisation_strings_string_StratHudbutton_Cannot_Build1	You cannot afford to construct this. Cost:	false
random_localisation_strings_string_StratHudbutton_Cannot_Build2	[[col:red]]Cannot build. This settlement is under siege.[[/col]]	false
random_localisation_strings_string_StratHudbutton_Cannot_Build3	[[col:red]]You must repair the first building in the chain before constructing another.[[/col]]	false
random_localisation_strings_string_StratHudbutton_Cannot_Embark/Disembark0	Cannot embark/disembark	false
random_localisation_strings_string_StratHudbutton_Cannot_Embark/Disembark1	The land here is inaccessible.	false
random_localisation_strings_string_StratHudbutton_Cannot_Embark/Disembark2	This fleet is too far from the shore or port.	false
random_localisation_strings_string_StratHudbutton_Cannot_Enlist_General0	Cannot enlist Lord	false
random_localisation_strings_string_StratHudbutton_Cannot_Enlist_General1	You have the maximum number of Lords already.	false
random_localisation_strings_string_StratHudbutton_Cannot_Enlist_General2	There are no candidates from which to pick a Lord.	false
random_localisation_strings_string_StratHudbutton_Cannot_Enlist_General3	Your fleet is already full, to recruit an admiral  you must scupper one of your ships.	false
random_localisation_strings_string_StratHudbutton_Cannot_Enlist_General4	Your army is already full, to recruit a general  you must disband one of your units.	false
random_localisation_strings_string_StratHudbutton_Cannot_Enlist_General5	You cannot afford to recruit a general. Cost:	false
random_localisation_strings_string_StratHudbutton_Cannot_Recruit_Unit0	[[col:red]]Cannot recruit unit.[[/col]]	false
random_localisation_strings_string_StratHudbutton_Cannot_Recruit_Unit1	There is no path available from this unit's place of recruitment to the recruiting force.	false
random_localisation_strings_string_StratHudbutton_Cannot_Recruit_Unit10	You haven't got the required resource for recruiting this unit.	false
random_localisation_strings_string_StratHudbutton_Cannot_Recruit_Unit2	[[col:red]]You have insufficient funds.[[/col]]	false
random_localisation_strings_string_StratHudbutton_Cannot_Recruit_Unit4	You cannot recruit a unit here while you are under siege	false
random_localisation_strings_string_StratHudbutton_Cannot_Recruit_Unit5	The recruitment building for this unit is damaged and must be repaired first.	false
random_localisation_strings_string_StratHudbutton_Cannot_Recruit_Unit6	The population number is too low to recruit from, you will have to wait until it grows.	false
random_localisation_strings_string_StratHudbutton_Cannot_Recruit_Unit7	{{tr:wh3_dlc23_cannot_recruit_unit_text}}	false
random_localisation_strings_string_StratHudbutton_Cannot_Recruit_Unit8	You cannot recruit this unit until you have studied and mastered the required art for it.	false
random_localisation_strings_string_StratHudbutton_Construction_Site	Undeveloped land||You can create new construction sites here.	false
random_localisation_strings_string_StratHudbutton_Damaged_Building	Damaged Building\\n\\n[[col:yellow]]Until repaired, this building's effects are diminished and it cannot be upgraded.[[/col]]	false
random_localisation_strings_string_StratHudbutton_Ruined_Building	Ruined Building\\n\\n[[col:yellow]]Until repaired, this building is ineffective.[[/col]]	false
random_localisation_strings_string_StratHudbutton_cannot_demolish	[[col:red]]You cannot demolish settlements and ports, roads, or speciality buildings at their base levels.[[/col]]	false
random_localisation_strings_string_StratHudbutton_cannot_disembark_here	Cannot disembark||You cannot disembark here, the land is inaccessible.	false
random_localisation_strings_string_StratHudbutton_cannot_enlist_full	Cannot enlist Lord||You already have a full quota of Lords.	false
random_localisation_strings_string_StratHudbutton_cannot_enlist_nocash	Cannot enlist a general||You have insufficient funds.	false
random_localisation_strings_string_StratHudbutton_cannot_navy_repair_nocash	Cannot repair||You have insufficient funds.||Disband an unused unit or increase taxes to raise funds. 	false
random_localisation_strings_string_StratHudbutton_cannot_repairShip_noport	Cannot repair||You can only repair ships at a port.	false
random_localisation_strings_string_StratHudbutton_cannot_repair_nocash	Cannot repair||You have insufficient funds.||Disband an unused unit or increase taxes to raise funds. 	false
random_localisation_strings_string_StratHudbutton_demolish	Demolish building	false
random_localisation_strings_string_StratHudbutton_limited_unit_type	You can only own a limited number of these items. You currently have %d of %d.	false
random_localisation_strings_string_Unit_Card_Generic_Function	Left-click to select, right-click for further information	false
random_localisation_strings_string_Unit_is_suffering_attrition	In winter, units in enemy territory will suffer losses due to attrition. Move the unit outside of the enemy area to stop further attrition.	false
random_localisation_strings_string_Unit_not_replenishing_01	[[col:red]]This unit is not replenishing because:[[/col]]	false
random_localisation_strings_string_Unit_not_replenishing_02	[[col:red]]- Local effects[[/col]]	false
random_localisation_strings_string_Unit_not_replenishing_03	[[col:red]]- There is no [[img:icon_general]][[/img]]Lord leading this army.[[/col]]	false
random_localisation_strings_string_Unit_not_replenishing_04	[[col:red]]- It is under siege.[[/col]]	false
random_localisation_strings_string_Unit_not_replenishing_05	[[col:red]]- You are bankrupt.[[/col]]	false
random_localisation_strings_string_Unit_not_replenishing_06	[[col:red]]- There is a local food shortage.[[/col]]	false
random_localisation_strings_string_Unit_not_replenishing_07	[[col:red]]- This army is in foreign territory.[[/col]]	false
random_localisation_strings_string_Unit_not_replenishing_08	[[col:red]]- This navy is in hostile waters.[[/col]]	false
random_localisation_strings_string_Unit_not_replenishing_09	{{tr:Unit_not_replenishing_09}}	false
random_localisation_strings_string_Unit_not_replenishing_10	[[col:red]]- Enemy army in region is blocking replenishment.[[/col]]	false
random_localisation_strings_string_Unit_not_replenishing_pooled_resource	Disabled by low supply of	false
random_localisation_strings_string_Unit_replenishing_in_friendly_territory	[[col:green]]This army is in a friendly province.[[/col]]	false
random_localisation_strings_string_Unit_replenishing_in_stance	[[col:green]]This army is in a replenishment-boosting stance.[[/col]]	false
random_localisation_strings_string_Unit_replenishment_complete_in	Turns until this unit is fully replenished: 	false
random_localisation_strings_string_Unit_replenishment_men_turn_count	Turns until next entity added: 	false
random_localisation_strings_string_Unit_replenishment_per_turn	Troops replenished per turn: 	false
random_localisation_strings_string_abandon_settlement	Abandon settlement	false
random_localisation_strings_string_abandon_tooltip	Abandon settlement||This will provide: {{tr:icon_treasury}} %d	false
random_localisation_strings_string_abandon_tooltip_pooled_resources	Abandon settlement||This will provide: [[img:%s]][[/img]]%d	false
random_localisation_strings_string_ability_abandon_artillery_engines	Drop Artillery or Engines||Drops your current siege engine or artillery piece.	false
random_localisation_strings_string_ability_blocked	Blocked	false
random_localisation_strings_string_ability_board_ship	Board Ship||Your troops carry out a boarding action against the enemy ship.	false
random_localisation_strings_string_ability_change_formation_spacing	Loose Spacing||Loose spacing minimises casualties when under heavy fire, but makes the unit more vulnerable in melee and to charges. 	false
random_localisation_strings_string_ability_defend	Toggle Guard Mode||This will put your troops on the defensive. Guard mode makes your unit hold position. Even if an enemy unit routs, it will remain in position and hold the line.	false
random_localisation_strings_string_ability_details	Ability details	false
random_localisation_strings_string_ability_disembark_from_ship	Disembark||Disembark from your ship.	false
random_localisation_strings_string_ability_dismount	Toggle Mount||Mounted units will need to dismount to completely capture victory points.	false
random_localisation_strings_string_ability_drop_siege_equipment	Drop Siege Equipment||Drops your current siege equipment.	false
random_localisation_strings_string_ability_effect_applied_instant	Instantly affects targets in area	false
random_localisation_strings_string_ability_effect_updates_every_frame	Only acts on targets when in area	false
random_localisation_strings_string_ability_fire_at_will	Toggle fire-at-will||Fire-at-will allows units to fire at enemies within range whenever they see fit. The effort of constantly firing and reloading quickly tires your troops, they will use their ammunition quickly, but not wisely.	false
random_localisation_strings_string_ability_formed_attack	Formation attack||The unit will try to stay in formation when in melee. Melee defence will be slightly increased.	false
random_localisation_strings_string_ability_left_click_cancel_targetting	Left-click to cancel targeting	false
random_localisation_strings_string_ability_left_click_cant_overcast	\\n[[col:red]](Cannot currently afford overcast)[[/col]]	false
random_localisation_strings_string_ability_left_click_cast	Left-click to activate	false
random_localisation_strings_string_ability_left_click_enable_targetting	Left-click to enable targeting	false
random_localisation_strings_string_ability_left_click_toggle_overcast	Left-click to enable [[col:magic]]overcast[[/col]] targeting	false
random_localisation_strings_string_ability_loose	Toggle Loose Formation||Loose formation spreads units out, making them much harder to hit with missiles, but greatly reduces their ability to resist charges.	false
random_localisation_strings_string_ability_naval_fire_at_will	Toggle Fire On/Off||When toggled off, the selected ship will stop firing and be unable to fire until toggled on again.	false
random_localisation_strings_string_ability_phase_mask_cant_move	[[col:red]][[img:ui/skins/default/ua_arrow_decrease_1.png]] Cannot move[[/col]]	false
random_localisation_strings_string_ability_phase_mask_freeze_fatigue	[[col:green]][[img:ui/skins/default/ua_arrow_increase_1.png]][[/img]] Freeze vigour[[/col]]	false
random_localisation_strings_string_ability_phase_mask_kill_self	[[col:red]]Kill Self[[/col]]	false
random_localisation_strings_string_ability_phase_mask_major_casualties	[[col:red]]Major Casualties[[/col]]	false
random_localisation_strings_string_ability_phase_mask_minor_casualties	[[col:red]]Minor Casualties[[/col]]	false
random_localisation_strings_string_ability_phase_mask_unbreakable	[[col:green]][[img:ui/skins/default/ua_arrow_increase_1.png]][[/img]] Unbreakable[[/col]]	false
random_localisation_strings_string_ability_release_animals	Release Animals||Unleash the beasts of war! The animals can only be released when you are close enough to the enemy, and will attack the closest unit to them.	false
random_localisation_strings_string_ability_skirmish	Toggle skirmish mode||In skirmish mode, units will keep a safe distance from the enemy. Skirmish tactics can be employed to slow an advancing enemy or distract specific units. Skirmish units are vulnerable to cavalry charges.	false
random_localisation_strings_string_ability_tooltip_cannot_target	Cannot target if	false
random_localisation_strings_string_ability_tooltip_cannot_target_alt	Target if	false
random_localisation_strings_string_ability_tooltip_disabled_when	Disabled if	false
random_localisation_strings_string_ability_tooltip_disabled_when_alt	Active if	false
random_localisation_strings_string_ability_tooltip_invalid_usages	Cannot use if	false
random_localisation_strings_string_ability_tooltip_invalid_usages_alt	Can use if	false
random_localisation_strings_string_ability_tooltip_phase	%d seconds / [[img:ui/skins/default/icon_cooldown.png]][[/img]]%d seconds	false
random_localisation_strings_string_ability_tooltip_recharge_context	Recharge if	false
random_localisation_strings_string_achievement_required	Achievement required	false
random_localisation_strings_string_action_result_type_critical_failure	Critical Failure	false
random_localisation_strings_string_action_result_type_critical_success	Critical Success	false
random_localisation_strings_string_action_result_type_failure	Failure	false
random_localisation_strings_string_action_result_type_guaranteed	[Placeholder]	false
random_localisation_strings_string_action_result_type_opportune_failure	Opportune Failure	false
random_localisation_strings_string_action_result_type_success	Success	false
random_localisation_strings_string_additional_content_required	Additional Content Required	false
random_localisation_strings_string_affects	Affects	false
random_localisation_strings_string_affects_self	Affects self	false
random_localisation_strings_string_affects_within_radius	Affects all %s within radius	false
random_localisation_strings_string_agent_cannot_act_force_full	[[col:red]]Cannot embed [[img:icon_hero]][[/img]]Hero. This army already has the maximum number of units within it.[[/col]]	false
random_localisation_strings_string_agent_cannot_act_settlement_full	PLACEHOLDER	false
random_localisation_strings_string_agent_deployment_effects_warning	{{tr:agent_deployment_effects_warning}}	false
random_localisation_strings_string_agent_help_string_agent_cap_reached	[[col:red]]Cannot recruit. You are already fielding the current maximum number of this type of [[img:icon_hero]][[/img]]Hero.[[/col]]	false
random_localisation_strings_string_agent_recruitment_click_to_recruit	{{tr:agent_recruitment_click_to_recruit}}	false
random_localisation_strings_string_agent_recruitment_insufficient_dev_points	[[col:red]]You do not have enough population surplus here to raise a new host.[[/col]]	false
random_localisation_strings_string_agent_recruitment_insufficient_money	[[col:red]]Cannot recruit. You have insufficient funds.[[/col]]	false
random_localisation_strings_string_agent_recruitment_insufficient_money_for_different_bodyguard	[[col:red]]You have insufficient funds.[[/col]]	false
random_localisation_strings_string_agent_recruitment_no_candidates	[[col:red]]There are no agent candidates available to recruit.[[/col]]	false
random_localisation_strings_string_agent_recruitment_no_settlment_selected	No settlement selected in which to recruit an agent.	false
random_localisation_strings_string_agent_recruitment_reduced_bodyguard	Not enough money - bodyguard will be depleted.	false
random_localisation_strings_string_agent_recruitment_reduced_changed_bodyguard	Not enough money to commission full new bodyguard - the current one will be depleted.	false
random_localisation_strings_string_ai_control	AI Control	false
random_localisation_strings_string_all	All	false
random_localisation_strings_string_all_units	All Units	false
random_localisation_strings_string_allied	Allied	false
random_localisation_strings_string_allied_forces	Your Alliance	false
random_localisation_strings_string_allied_mana	Allied Winds of Magic recharge	false
random_localisation_strings_string_allied_mencount	Allied troop count	false
random_localisation_strings_string_allied_recruitment_other_faction_unit_tooltip	This unit is provided to them by their ally: %s	false
random_localisation_strings_string_allied_recruitment_unit_tooltip	This unit is provided to you by your ally: %s. If your alliance ends as a result of you or your ally breaking it, the unit will be disbanded.	false
random_localisation_strings_string_ally	Ally	false
random_localisation_strings_string_ally_attacked_ally_attack_ally	Your allies at war with each other!	false
random_localisation_strings_string_ally_attacked_ally_attacking	Your ally declares war!	false
random_localisation_strings_string_ally_attacked_ally_defending	Your ally has been attacked!	false
random_localisation_strings_string_always	Always	false
random_localisation_strings_string_ancillary_assigned	This item or follower is currently assigned to %S.	false
random_localisation_strings_string_ancillary_unlocking_next_turn	[[col:yellow]]Household member/object in transit. It will take effect as of the next turn.[[/col]]	false
random_localisation_strings_string_ap_vortex_damage	[[img:ui/skins/default/icon_vortex_damage_ap.png]][[/img]] Armour-piercing Vortex Damage: %d	false
random_localisation_strings_string_army_recruitment_limit_reached	[[col:red]]You have recruited the maximum number of units into this army.[[/col]]	false
random_localisation_strings_string_army_trapped_in_enemy_ZOC	\\n[[col:yellow]]This army is inside an enemy zone of control and cannot move. Attacking the enemy is its only option.[[/col]]	false
random_localisation_strings_string_around_self	Around self	false
random_localisation_strings_string_art_active	Left-click to research this technology. 	false
random_localisation_strings_string_art_already_researched	You have already researched this technology.	false
random_localisation_strings_string_art_being_researched	You are currently researching this technology.	false
random_localisation_strings_string_art_unavailable	Left-click to set a goal for this technology.||The technologies required to unlock this will be researched automatically.	false
random_localisation_strings_string_ascendant_lore_cooldown_modifier	Decreased cooldown for %S spells: %d%%	false
random_localisation_strings_string_at_peace	At Peace	false
random_localisation_strings_string_at_war	At War	false
random_localisation_strings_string_attacker	Attacker	false
random_localisation_strings_string_attacker_direction_east	East	false
random_localisation_strings_string_attacker_direction_north	North	false
random_localisation_strings_string_attacker_direction_south	South	false
random_localisation_strings_string_attacker_direction_west	West	false
random_localisation_strings_string_attrition_cold	In winter, armies will suffer losses due to attrition if they are in enemy territory. 	false
random_localisation_strings_string_attrition_cold_immune	Units in your army are immune from Winter attrition.	false
random_localisation_strings_string_attrition_heat	This is an area of ATTRITION. Armies will suffer losses here due to the extreme heat.	false
random_localisation_strings_string_attrition_heat_immune	Units in your army are immune from desert attrition.	false
random_localisation_strings_string_attrition_immunity	Resilience||This unit is immune to the following types of [[img:icon_attrition]][[/img]]attrition:	false
random_localisation_strings_string_attrition_sea	Ships that move here will suffer attrition	false
random_localisation_strings_string_audio_provider_4_0	4.0 discrete	false
random_localisation_strings_string_audio_provider_5_1	5.1 discrete	false
random_localisation_strings_string_audio_provider_6_1	6.1 discrete	false
random_localisation_strings_string_audio_provider_7_1	7.1 discrete	false
random_localisation_strings_string_audio_provider_8_1	8.1 discrete	false
random_localisation_strings_string_audio_provider_directsound_3d_hardware	DirectSound 3D hardware	false
random_localisation_strings_string_audio_provider_dolby_surround	Dolby surround	false
random_localisation_strings_string_audio_provider_mono	Mono	false
random_localisation_strings_string_audio_provider_srs_circle_surround	SRS Circle Surround	false
random_localisation_strings_string_audio_provider_stereo_headphones	Stereo headphones	false
random_localisation_strings_string_audio_provider_stereo_speakers	Stereo speakers	false
random_localisation_strings_string_audio_provider_windows_default	Windows default	false
random_localisation_strings_string_auto_resolve	Auto-resolve	false
random_localisation_strings_string_auto_save_filename	Auto-save	false
random_localisation_strings_string_auto_save_filename_legendary	Auto-save (Ironman)	false
random_localisation_strings_string_autosaving	Auto-saving...	false
random_localisation_strings_string_barrier	[[img:ui/campaign ui/effect_bundles/barrier.png]][[/img]] Barrier	false
random_localisation_strings_string_barrier_description	Barrier health is depleted before unit health when taking damage. The barrier health will slowly replenish when not taking damage. Maximum barrier health is proportional to remaining unit health. 	false
random_localisation_strings_string_base_vortex_damage	[[img:ui/skins/default/icon_vortex_damage.png]][[/img]] Base Vortex Damage: %d	false
random_localisation_strings_string_battle_barrier_hp_regen	[[col:magic_barrier]]%.1f BP/s[[/col]]	false
random_localisation_strings_string_battle_cannot_dismantle_post_deployment	[[col:red]]Buildings cannot be dismantled after the deployment phase[[/col]]	false
random_localisation_strings_string_battle_dismantle_building	Dismantle||Dismantle this building for a refund of %d supplies	false
random_localisation_strings_string_battle_draw	Draw||The only winner here is the Blood God.	false
random_localisation_strings_string_battle_hp_regen	%.1f HP/s	false
random_localisation_strings_string_battle_invalid_ship_docking_point	Another ship is already heading to this destination. You will have to find an alternate landing point.	false
random_localisation_strings_string_battle_reduced_health_cap	%d/[[col:red]]%d[[/col]]	false
random_localisation_strings_string_battle_regroup_position_marker	Regroup position	false
random_localisation_strings_string_battle_time_limit	%d minutes	false
random_localisation_strings_string_battle_time_remaining	Time remaining:	false
random_localisation_strings_string_battle_toggleable_slot_buildable	Build Location||Select this location to build a defensive structure.	false
random_localisation_strings_string_battle_tooltip_yang_bonus	Harmony: Yang	false
random_localisation_strings_string_battle_tooltip_yin_bonus	Harmony: Yin	false
random_localisation_strings_string_battle_warning_returning_to_postbattle	Exiting battle in:	false
random_localisation_strings_string_benchmark_average_cpu_main	Average CPU Framerate (main thread)	false
random_localisation_strings_string_benchmark_average_cpu_render	Average CPU Framerate (render thread)	false
random_localisation_strings_string_benchmark_average_gpu	Average GPU Framerate	false
random_localisation_strings_string_benchmark_dialog_body	Do you want to exit the current benchmark?	false
random_localisation_strings_string_benchmark_dialog_title	Exit Benchmark	false
random_localisation_strings_string_blank_entry		false
random_localisation_strings_string_blockaded	[[col:red]]Obstructed[[/col]]	false
random_localisation_strings_string_bonus	Bonus:	false
random_localisation_strings_string_bribe_nonhostile_description	You are attempting to manipulate a non-hostile agent into joining your faction. This is an act of war.\\nHow will you proceed?	false
random_localisation_strings_string_bribe_nonhostile_panel_title	Manipulation Attempt	false
random_localisation_strings_string_building_construction_blocked_by_character	Unable to expand. You must ensure you have a building in the previous slot and check there are no nearby characters blocking the expansion.	false
random_localisation_strings_string_building_construction_requires_main_slot_upgrade	{{tr:building_construction_requires_main_slot_upgrade}}	false
random_localisation_strings_string_building_culture_conversion	Conversion cost due to local culture	false
random_localisation_strings_string_building_damage_high	[[img:ui/skins/default/weapon_building_damage_modifier.png]][[/img]] This unit causes a large amount damage against buildings.	false
random_localisation_strings_string_building_damage_low	[[img:ui/skins/default/weapon_building_damage_modifier.png]][[/img]] This unit causes a small amount damage against buildings.	false
random_localisation_strings_string_building_damage_medium	[[img:ui/skins/default/weapon_building_damage_modifier.png]][[/img]] This unit causes a medium amount damage against buildings.	false
random_localisation_strings_string_building_damage_multiplier_percentage	[[img:ui/skins/default/weapon_building_damage_modifier.png]][[/img]] This unit has a [[col:%s]]%+d%%[[/col]] damage multiplier against buildings.	false
random_localisation_strings_string_building_damage_very_high	[[img:ui/skins/default/weapon_building_damage_modifier.png]][[/img]] This unit causes a very large amount damage against buildings.	false
random_localisation_strings_string_building_insufficent_development_points	You don’t have enough [[img:icon_pop_surplus]][[/img]]population surplus.||Upgrade your settlements to increase your [[img:icon_growth]][[/img]]growth rate.	false
random_localisation_strings_string_building_insufficent_development_points_number	[[col:red]]You need %n [[img:icon_pop_surplus]][[/img]]population surplus to order this construction.[[/col]]	false
random_localisation_strings_string_building_under_construction_damaged	This unfinished building is damaged and all construction on it has halted. Select it and click the Repair button to fix it and continue the construction.	false
random_localisation_strings_string_building_under_construction_damaged_cancel_repair	[[col:yellow]]Cancelling the repair of this unfinished building will leave it in a damaged state. Construction on it will not start again until it has been repaired.[[/col]]	false
random_localisation_strings_string_building_under_construction_damaged_cannot	No unfinished buildings are damaged 	false
random_localisation_strings_string_building_under_construction_damaged_demolish	Click here to cancel repair of unfinished buildings.	false
random_localisation_strings_string_building_under_construction_damaged_repair	Repair unfinished building.	false
random_localisation_strings_string_burst	Shots per volley	false
random_localisation_strings_string_button_cancel_slot_instruction_active	Click this button to cancel any action on the currently selected item.	false
random_localisation_strings_string_button_cancel_slot_instruction_inactive	You must select an item before using this button.	false
random_localisation_strings_string_campaign_autoresolver_tooltip_stance_defensive	Protective Stance||Your units will assume a defensive position, and will attempt to retreat if things get out of control.\\n\\nThis stance is usually more effective when you have missile superiority.\\n\\nExpect lower casualties on both sides.	false
random_localisation_strings_string_campaign_autoresolver_tooltip_stance_land_aggressive	Aggressive Stance||Your units will try to rush the enemy. This stance is usually more effective when the enemy has missile superiority.\\n\\nRetreat will be more difficult for both sides.\\n\\nExpect higher casualties.	false
random_localisation_strings_string_campaign_autoresolver_tooltip_stance_land_balanced	Balanced Stance||When using the balanced battle stance, units will receive no bonuses or penalties.	false
random_localisation_strings_string_campaign_autoresolver_tooltip_stance_naval_aggressive	Aggressive Stance||Your units will try to rush the enemy. This stance is usually more effective when the enemy has missile superiority.\\n\\nRetreat will be more difficult for both sides.\\n\\nExpect higher casualties.	false
random_localisation_strings_string_campaign_autoresolver_tooltip_stance_naval_balanced	Balanced Stance||When using the balanced battle stance, units will receive no bonuses or penalties.	false
random_localisation_strings_string_campaign_autoresolver_tooltip_stance_naval_defensive	Protective Stance||Your units will assume a defensive position, and will attempt to retreat if things get out of control.\\n\\nThis stance is usually more effective when you have missile superiority.\\n\\nExpect lower casualties on both sides.	false
random_localisation_strings_string_campaign_autoresolver_tooltip_stance_siege_aggressive	Aggressive Stance||Your units will try to rush the enemy. This stance is usually more effective when the enemy has missile superiority.\\n\\nRetreat will be more difficult for both sides\\n\\nExpect higher casualties.	false
random_localisation_strings_string_campaign_autoresolver_tooltip_stance_siege_balanced	Balanced Stance||When using the balanced battle stance, units will receive no bonuses or penalties.	false
random_localisation_strings_string_campaign_autoresolver_tooltip_stance_siege_defensive	Protective Stance||Your units will assume a defensive position, and will attempt to retreat if things get out of control.\\n\\nThis stance is usually more effective when you have missile superiority.\\n\\nExpect lower casualties on both sides.	false
random_localisation_strings_string_campaign_intro_warning	This Lord's campaign does not feature an opening battle, are you sure you want to continue?\\n\\nSelect a Lord with a campaign introduction to learn the basics of Total War: WARHAMMER II.	false
random_localisation_strings_string_campaign_radar_sort_by_speciality	Sort by speciality	false
random_localisation_strings_string_campaign_type_co_op	Co-op	false
random_localisation_strings_string_campaign_type_co_op_long	Co-operative Long	false
random_localisation_strings_string_campaign_type_co_op_short	Co-operative Short	false
random_localisation_strings_string_campaign_type_long	Long Campaign	false
random_localisation_strings_string_campaign_type_one_vs_one	Head to Head	false
random_localisation_strings_string_campaign_type_prestige	Prestige Victory	false
random_localisation_strings_string_campaign_type_short	Short Campaign	false
random_localisation_strings_string_campaign_type_world_domination	Domination Campaign	false
random_localisation_strings_string_campaing_public_order_tooltip_header	{{tr:public_order}} Details	false
random_localisation_strings_string_can_siege_tooltip	Siege Attacker||This unit can attack city gates, allowing you to instantly launch a siege battle without having to wait for towers or battering rams to be built.	false
random_localisation_strings_string_can_target	Can target	false
random_localisation_strings_string_cancel	Cancel	false
random_localisation_strings_string_cancel_construction_confirmation	This building is still being constructed, are you sure you wish to cancel construction?	false
random_localisation_strings_string_cancel_construction_header	Cancel construction	false
random_localisation_strings_string_cancel_demolish_building	This building will be demolished once your turn has ended. Left-click to cancel the order.	false
random_localisation_strings_string_cancel_demolish_building_once_settled	{{tr:cancel_demolish_building_once_settled}}	false
random_localisation_strings_string_cancel_recruitment_confirmation	This unit is in the process of being recruited, are you sure you wish to cancel recruiting it?	false
random_localisation_strings_string_cancel_recruitment_header	Cancel Recruitment	false
random_localisation_strings_string_cancel_repair_building	This building will be repaired once your turn has ended. Left-click to cancel repair order.	false
random_localisation_strings_string_cannot_afford_to_repair_pooled_resources	[[col:red]]You cannot afford to repair this building.\\nCost: [[img:%s]][[/img]] %d [[/col]]	false
random_localisation_strings_string_cannot_begin_battle_map_downloading	You cannot start the game until the map has finished downloading.	false
random_localisation_strings_string_cannot_build_insufficient_food	{{tr:cannot_build_insufficient_food}}	false
random_localisation_strings_string_cannot_build_insufficient_funds	[[col:red]]You have insufficient funds to order this construction.[[/col]]	false
random_localisation_strings_string_cannot_build_tech_required	Required technology needs to be researched before this building can be constructed.	false
random_localisation_strings_string_cannot_change_ui_theme	[[col:red]]Main UI theme cannot be changed in this game mode.[[/col]]	false
random_localisation_strings_string_cannot_dismantle_ruin	[[col:red]]This building cannot be demolished.[[/col]]	false
random_localisation_strings_string_cannot_enter_enemy_zoc	\\n[[col:yellow]]You cannot enter an enemy zone of control unless making an attack.[[/col]]	false
random_localisation_strings_string_cannot_merge_agent_not_enough_action_points	This [[img:icon_hero]][[/img]]Hero does not have enough movement range to reach the other army.	false
random_localisation_strings_string_cannot_recruit_insufficient_funds	You have insufficient funds to recruit this unit.	false
random_localisation_strings_string_cannot_recruit_queue_full	Your recruitment queue is full, remove other items in order to queue this unit.	false
random_localisation_strings_string_cannot_reinforce_at_night	[[col:red]]This army cannot reinforce during a lightning strike battle.[[/col]]	false
random_localisation_strings_string_cannot_show_projectile_stats	\\n\\n(Cannot display projectile stats when multiple units are selected with different projectiles.)	false
random_localisation_strings_string_capital	Faction Capital	false
random_localisation_strings_string_capture_point_child_attacker_contest_warning	[[col:red]]You are losing control of '%s'. If control is lost, you will no longer be able to contest or gain victory tickets from this location[[/col]]	false
random_localisation_strings_string_capture_point_child_attacker_info	[[col:yellow]]You must have '%s' under control to contest and gain victory tickets from this location[[/col]]	false
random_localisation_strings_string_capture_point_child_defender_info	[[col:yellow]]While '%s' is under your control, attackers will not be able to contest or gain victory tickets from this location[[/col]]	false
random_localisation_strings_string_capture_point_parent_attacker_contest_warning	[[col:red]]You are losing control of this location. If control is lost, you will no longer be able to contest or gain victory tickets from '%s'[[/col]]	false
random_localisation_strings_string_capture_point_parent_attacker_info	[[col:yellow]]You must have this location under control to contest and gain victory tickets from '%s'[[/col]]	false
random_localisation_strings_string_capture_point_parent_defender_info	[[col:yellow]]While this location is under your control, attackers will not be able to contest or gain victory tickets from '%s'[[/col]]	false
random_localisation_strings_string_cast_range	[[img:ui/skins/default/icon_distance_to_target.png]][[/img]]	false
random_localisation_strings_string_cast_range_tooltip	Maximum distance the spell can be cast.	false
random_localisation_strings_string_causes	Imbues	false
random_localisation_strings_string_character_details_panel_max	Maximum	false
random_localisation_strings_string_character_details_panel_min	Minimum	false
random_localisation_strings_string_character_details_rank_1	Current rank: 1 (maximum 6)||A character's rank shows their overall level of skill, with each star representing one rank level.||New rank levels are achieved by gaining experience. With each new level you will be able to pick additional skills.	false
random_localisation_strings_string_character_details_rank_2	Current rank: 2 (maximum 6)||A character's rank shows their overall level of skill, with each star representing one rank level.||New rank levels are achieved by gaining experience. With each new level you will be able to pick additional skills.	false
random_localisation_strings_string_character_details_rank_3	Current rank: 3 (maximum 6)||A character's rank shows their overall level of skill, with each star representing one rank level.||New rank levels are achieved by gaining experience. With each new level you will be able to pick additional skills.	false
random_localisation_strings_string_character_details_rank_4	Current rank: 4 (maximum 6)||A character's rank shows their overall level of skill, with each star representing one rank level.||New rank levels are achieved by gaining experience. With each new level you will be able to pick additional skills.	false
random_localisation_strings_string_character_details_rank_5	Current rank: 5 (maximum 6)||A character's rank shows their overall level of skill, with each star representing one rank level.||New rank levels are achieved by gaining experience. With each new level you will be able to pick additional skills.	false
random_localisation_strings_string_character_details_rank_6	Current rank: 6 (maximum 6)||A character's rank shows their overall level of skill, with each star representing one rank level.||New rank levels are achieved by gaining experience. With each new level you will be able to pick additional skills.	false
random_localisation_strings_string_character_experience_progress_bar	Experience gained at this level:	false
random_localisation_strings_string_character_panel_loyalty_honour_negative	Negative Factors	false
random_localisation_strings_string_character_panel_loyalty_honour_positive	Positive Factors	false
random_localisation_strings_string_character_role_admiral	[[img:icon_admiral]][[/img]]Admiral	false
random_localisation_strings_string_character_role_candidate	PLACEHOLDER	false
random_localisation_strings_string_character_role_daughter	PLACEHOLDER	false
random_localisation_strings_string_character_role_deceased	Deceased Character	false
random_localisation_strings_string_character_role_general	[[img:icon_general]][[/img]]Lord	false
random_localisation_strings_string_character_role_governor	[[img:icon_overseer]][[/img]]Overseer	false
random_localisation_strings_string_character_role_politician	[[img:icon_protagonist]][[/img]]Protagonist	false
random_localisation_strings_string_character_role_retainer	Retainer	false
random_localisation_strings_string_character_role_son	PLACEHOLDER	false
random_localisation_strings_string_character_role_wife	PLACEHOLDER	false
random_localisation_strings_string_character_situation_conversion	Province Conversion	false
random_localisation_strings_string_character_situation_conversion_catholic	Province Conversion	false
random_localisation_strings_string_character_situation_cunning_bribe	Bribery	false
random_localisation_strings_string_character_situation_cunning_counterspy	Counter-spying	false
random_localisation_strings_string_character_situation_cunning_hunt_down	Apprehension	false
random_localisation_strings_string_character_situation_cunning_oversee_army	Overseeing Army	false
random_localisation_strings_string_character_situation_cunning_oversee_town	Overseeing Settlement	false
random_localisation_strings_string_character_situation_entertaining_generals	Entertaining Lords	false
random_localisation_strings_string_character_situation_entertaining_nobles	Entertaining nobles	false
random_localisation_strings_string_character_situation_land_ambush	Ambushes	false
random_localisation_strings_string_character_situation_land_amphibious_attack	Coastal Assaults	false
random_localisation_strings_string_character_situation_land_attack	Field Attacks	false
random_localisation_strings_string_character_situation_land_defence	Field Defence	false
random_localisation_strings_string_character_situation_land_siege_attack	Siege Attacks	false
random_localisation_strings_string_character_situation_land_siege_defence	Siege Defence	false
random_localisation_strings_string_character_situation_paying_off	Paying Off	false
random_localisation_strings_string_character_situation_requesting_allegiance	Requesting Allegiance	false
random_localisation_strings_string_character_situation_sea_attack	Naval Attacks	false
random_localisation_strings_string_character_situation_sea_defence	Naval Defence	false
random_localisation_strings_string_character_situation_seducing	Seducing	false
random_localisation_strings_string_character_situation_subterfuge_assassination	Assassinations	false
random_localisation_strings_string_character_situation_subterfuge_field_scout	Scouting	false
random_localisation_strings_string_character_situation_subterfuge_sabotage_army	Army Sabotage	false
random_localisation_strings_string_character_situation_subterfuge_sabotage_building	Building Sabotage	false
random_localisation_strings_string_character_situation_subterfuge_spy_network	Spy Networks	false
random_localisation_strings_string_character_situation_subterfuge_spying	Spying	false
random_localisation_strings_string_character_situation_zeal_convert_character	Character Conversion	false
random_localisation_strings_string_character_situation_zeal_demoralise_army	Demoralising Armies	false
random_localisation_strings_string_character_situation_zeal_incite_unrest	Inciting Unrest	false
random_localisation_strings_string_character_situation_zeal_inspire_army	Inspiring Armies	false
random_localisation_strings_string_character_type_title_brother	Brother	false
random_localisation_strings_string_character_type_title_general	Lord	false
random_localisation_strings_string_character_type_title_son	Son	false
random_localisation_strings_string_character_type_title_sonandheir	Son & Heir	false
random_localisation_strings_string_chat_help_text	HELP\\nCommand format: /command argument1 argument2 \\nYou can cycle through suggestions with the UP/DOWN keys, and press TAB to select a suggestion (for chat commands and player names).\\n\\nAvailable commands:\\n	false
random_localisation_strings_string_chat_intro_text	Type /help for a list of available chat shortcuts for your current game area.	false
random_localisation_strings_string_chat_ping_msg	Ping placed	false
random_localisation_strings_string_chat_prefix_team	[to team]	false
random_localisation_strings_string_chat_telestration_msg	Telestration message sent	false
random_localisation_strings_string_clear_advice_warning	You are about to clear your advice history. Are you sure?	false
random_localisation_strings_string_click_to_mark_current_selection_for_dismantling	Demolish	false
random_localisation_strings_string_click_to_show_on_map	Click to show on map	false
random_localisation_strings_string_cloud_save_failed_message	The game failed to save to the cloud, is there enough space remaining?	false
random_localisation_strings_string_cloud_save_failed_title	Game Save Failed	false
random_localisation_strings_string_cloud_storage_remaining	Cloud storage remaining: %u%	false
random_localisation_strings_string_confirm_battle_type_change_msg	Changing to this battle type will result in kicking some players.\\n\\nAre you sure you wish to proceed?	false
random_localisation_strings_string_confirm_delete_msg	This will delete all selected files. Continue?	false
random_localisation_strings_string_confirm_delete_playthrough_msg	This will only delete saves that currently display in the list for the selected playthrough. Continue?\\n\\nTo display all existing save files, cancel and use the Display All Saves button.	false
random_localisation_strings_string_confirm_delete_title	Confirm Deletion	false
random_localisation_strings_string_confirm_exit_ranked_battle	You are about to exit a ranked battle lobby.\\n\\nAre you sure you wish to proceed?	false
random_localisation_strings_string_confirm_rematch_battle	Are you sure you want to rematch this battle?	false
random_localisation_strings_string_constant	Constant	false
random_localisation_strings_string_contact_effect	Contact	false
random_localisation_strings_string_content_locked	Content Locked	false
random_localisation_strings_string_context_viewer_command_needs_args	\\n\\n[[col:red]]This command has mandatory arguments so cannot simply be pressed.\\nYou must use the expression test text input at the bottom of the context viewer to test it out, entering the command and passing the correct parameters.[[/col]]	false
random_localisation_strings_string_context_viewer_commands	Commands	false
random_localisation_strings_string_context_viewer_context_shortcuts	Context shortcuts:	false
random_localisation_strings_string_context_viewer_db_tables	Database tables:	false
random_localisation_strings_string_context_viewer_queries	Queries	false
random_localisation_strings_string_context_viewer_search_results	Search results:	false
random_localisation_strings_string_controls_empty	<Empty>	false
random_localisation_strings_string_controls_load_key_list	Load Keys List	false
random_localisation_strings_string_controls_save_key_list	Save Key List	false
random_localisation_strings_string_cooldown	Cooldown	false
random_localisation_strings_string_copy_protection_message	text_rejected	false
random_localisation_strings_string_corruption_details	Corruption Details	false
random_localisation_strings_string_corruption_details_description	{{tr:corruption_tooltip}}	false
random_localisation_strings_string_cost	Cost: {{tr:icon_money}}	false
random_localisation_strings_string_cost_control	{{tr:public_order}} cost: [[img:icon_public_order]][[/img]]	false
random_localisation_strings_string_cpu	CPU	false
random_localisation_strings_string_cpu_player	CPU %d	false
random_localisation_strings_string_created_by	Created by	false
random_localisation_strings_string_cursor_size_auto	Automatic	false
random_localisation_strings_string_custom_battle_made_by_string	by %s	false
random_localisation_strings_string_custom_battle_unit_tooltip_cannot_recruit_zero_cap	[[col:red]]Unable to recruit with unit caps enabled.[[/col]]	false
random_localisation_strings_string_custom_battle_unit_tooltip_matchmade_cant_afford	\\n[[col:red]]Cannot recruit. Cannot overspend in match-made battles.[[/col]]	false
random_localisation_strings_string_custom_battle_unit_tooltip_player_cap	\\n[[col:red]]Cannot recruit. Army is full.[[/col]]	false
random_localisation_strings_string_custom_battle_unit_tooltip_recruit	\\nDouble left-click to recruit	false
random_localisation_strings_string_custom_battle_unit_tooltip_reinforcement_cap	\\n[[col:red]]Cannot recruit. Reinforcing army is full.[[/col]]	false
random_localisation_strings_string_custom_battle_unit_tooltip_remove	\\nDouble left-click to remove unit	false
random_localisation_strings_string_damage	Damage	false
random_localisation_strings_string_damage_per_second	Damage Per Second	false
random_localisation_strings_string_damaged	Damaged	false
random_localisation_strings_string_damages_within_radius	Damages all %s within radius	false
random_localisation_strings_string_day	Day	false
random_localisation_strings_string_declare_war_ally_not_requested_help	This ally has not requested your assistance in this war.	false
random_localisation_strings_string_decline_breaks_alliance_defender	Decline (breaks alliance with defender)	false
random_localisation_strings_string_decrease_experience	Decrease experience	false
random_localisation_strings_string_decreasing	Deteriorating	false
random_localisation_strings_string_default	Default	false
random_localisation_strings_string_defeat	Defeat	false
random_localisation_strings_string_defender	Defender	false
random_localisation_strings_string_delayed	Delayed	false
random_localisation_strings_string_demo_battle_unavailable	This option is limited to key battles in the demo. You must autoresolve this battle.	false
random_localisation_strings_string_demo_save_disabled	Saving is temporarily disabled.||The game will autosave throughout the campaign.	false
random_localisation_strings_string_demolish_tooltip	Demolish building||This will refund: {{tr:icon_treasury}} %d	false
random_localisation_strings_string_demolish_tooltip_pooled_resources	Demolish building||This will provide: [[img:%s]][[/img]]%d	false
random_localisation_strings_string_description	Description	false
random_localisation_strings_string_desolate	Ruins	false
random_localisation_strings_string_destroy_loyalty_warning	\\n\\n{{tr:disband_loyalty_explanation}}	false
random_localisation_strings_string_destroy_transported_title	Disbanding	false
random_localisation_strings_string_destroy_transported_warning	Are you sure you wish to disband the selection?\\n\\nAny [[img:icon_general]][[/img]]Lords will be returned to the recruitment pool. Any [[img:icon_hero]][[/img]]Heroes will be permanently disbanded, regardless of immortality.	false
random_localisation_strings_string_difficulty_change_confirmation	Are you sure you want to change difficulty?	false
random_localisation_strings_string_difficulty_level_0_tooltip_battle	Enemy forces have their AI disabled, but automatic behaviours such as melee combat reactions and fire-at-will still behave as normal.	false
random_localisation_strings_string_difficulty_level_1	Easy	false
random_localisation_strings_string_difficulty_level_1_description_battle	Enemy forces have poor reaction times.\\n Thus making them easier to defeat.	false
random_localisation_strings_string_difficulty_level_1_description_campaign	Your faction will gain [[img:icon_public_order]][[/img]]control and [[img:icon_money]][[/img]]upkeep bonuses, and enemy armies may attack rashly when you outnumber them.	false
random_localisation_strings_string_difficulty_level_1_tooltip_battle	Enemy forces have very low reaction times, making them easier to defeat.	false
random_localisation_strings_string_difficulty_level_1_tooltip_campaign	Your faction will gain [[img:icon_public_order]][[/img]]control and [[img:icon_money]][[/img]]upkeep bonuses, and enemy armies may attack rashly when you outnumber them.	false
random_localisation_strings_string_difficulty_level_2	Normal	false
random_localisation_strings_string_difficulty_level_2_description_battle	Enemy forces have lower reaction times.\\n Will try and evade Spells.\\n Offering a reasonable level of challenge.	false
random_localisation_strings_string_difficulty_level_2_description_campaign	Enemy factions are not affected by significant penalties or bonuses and plan their moves with greater care.	false
random_localisation_strings_string_difficulty_level_2_tooltip_battle	Enemy forces have low reaction times but try to evade Spells and offer a reasonable level of challenge.	false
random_localisation_strings_string_difficulty_level_2_tooltip_campaign	Enemy factions are not affected by significant penalties or bonuses and plan their moves with greater care.	false
random_localisation_strings_string_difficulty_level_3	Hard	false
random_localisation_strings_string_difficulty_level_3_description_battle	Enemy forces are smarter, have decent reaction times.\\n Have a basic ranged targeting selection by differentiating between soft and armoured targets.\\n Will try and evade Spells.\\n Good tactics are essential.	false
random_localisation_strings_string_difficulty_level_3_description_campaign	Enemy factions pay less for [[img:icon_money]][[/img]]upkeep and unit recruitment along with various additional bonuses.	false
random_localisation_strings_string_difficulty_level_3_tooltip_battle	Enemy forces have normal reaction times and are smarter. They will try to evade Spells and use basic ranged targeting selection by differentiating between soft and armoured targets.	false
random_localisation_strings_string_difficulty_level_3_tooltip_campaign	Enemy factions pay less for [[img:icon_money]][[/img]]upkeep and unit recruitment along with various additional bonuses.	false
random_localisation_strings_string_difficulty_level_4	Very Hard	false
random_localisation_strings_string_difficulty_level_4_description_battle	Even the lowliest enemy soldier is formidable.\\n Enemy forces have good reaction times.\\n A robust ranged targeting selection.\\n Will try and evade Spells and Artillery projectiles.\\n  Prepare for the fight of your life.	false
random_localisation_strings_string_difficulty_level_4_description_campaign	With significantly lower [[img:icon_money]][[/img]]upkeep costs, enemy factions will field more armies and make swifter campaign progress while enjoying many other bonuses.	false
random_localisation_strings_string_difficulty_level_4_tooltip_battle	Enemy forces have good reaction times, making even the lowliest soldier formidable! They will try to evade Spells and artillery projectiles, and use robust ranged targeting selection to pose a higher threat.	false
random_localisation_strings_string_difficulty_level_4_tooltip_campaign	With significantly lower [[img:icon_money]][[/img]]upkeep costs, enemy factions will field more armies and make swifter campaign progress while enjoying many other bonuses.	false
random_localisation_strings_string_difficulty_level_5	Legendary	false
random_localisation_strings_string_difficulty_level_5_description_campaign	With significantly lower [[img:icon_money]][[/img]]upkeep costs, enemy factions will field more armies and make swifter campaign progress while enjoying many other bonuses.\\n\\n[[col:red]]Orders cannot be issued when a battle is paused.[[/col]]	false
random_localisation_strings_string_difficulty_level_5_tooltip_campaign	With significantly lower [[img:icon_money]][[/img]]upkeep costs, enemy factions will field more armies and make swifter campaign progress while enjoying many other bonuses.\\n\\n[[col:red]]Orders cannot be issued when a battle is paused.[[/col]]	false
random_localisation_strings_string_difficulty_modifier	Difficulty modifier	false
random_localisation_strings_string_diplomacy_button_cannot_trade_embargo	There are no trade routes to declare an embargo against.	false
random_localisation_strings_string_diplomacy_button_need_access_to_cancel_access	There is no military access to cancel.	false
random_localisation_strings_string_diplomacy_button_need_alliance_to_request_alliance	There is no alliance to cancel.	false
random_localisation_strings_string_diplomacy_button_no_trade_agreement_to_cancel	There is no trade agreement to cancel.	false
random_localisation_strings_string_diplomacy_panel_hostage_given	Their hostage given:	false
random_localisation_strings_string_diplomacy_panel_hostage_held	Your hostage held:	false
random_localisation_strings_string_diplomacy_undiscovered_clan_mon	Undiscovered Faction	false
random_localisation_strings_string_directx_version_changed	DirectX version changed. This will be applied when you next restart Total War: WARHAMMER II.	false
random_localisation_strings_string_dlc_menu_button_offline	You must be online to view DLC packs.	false
random_localisation_strings_string_dlc_menu_button_own_all	You own all available DLC packs.	false
random_localisation_strings_string_dlc_permission_collections	To unlock %s you must own all products listed in one of the following collections:	false
random_localisation_strings_string_dlc_permission_products	To unlock %s you must own all products listed in the following collection:	false
random_localisation_strings_string_dlc_purchase_body	Thank you. Please restart Total War: WARHAMMER II to download and play this DLC pack.	false
random_localisation_strings_string_dlc_purchase_title	DLC acquired	false
random_localisation_strings_string_double_left_click_to_zoom	Double left-click to zoom to this location.	false
random_localisation_strings_string_duration	Duration	false
random_localisation_strings_string_dx12_inactive_tooltip	To run DirectX® 12 (BETA) you must be running Windows 10 and have a DirectX® 12 compatible graphics card.	false
random_localisation_strings_string_early	Early	false
random_localisation_strings_string_easy	Easy	false
random_localisation_strings_string_effect_bundle_from_event	Event:	false
random_localisation_strings_string_effect_bundle_target_local	Province:	false
random_localisation_strings_string_effect_bundle_time	Seasons Remaining	false
random_localisation_strings_string_effect_bundle_tooltip	Current effects||Successfully completing missions and facing certain game events will trigger short-term effects upon your Clan or provinces.	false
random_localisation_strings_string_effects	Effects	false
random_localisation_strings_string_enemies	enemy entities	false
random_localisation_strings_string_enemy	Enemy	false
random_localisation_strings_string_enemy_mana	Enemy Winds of Magic recharge	false
random_localisation_strings_string_enemy_mencount	Enemy troop count	false
random_localisation_strings_string_entities	entities	false
random_localisation_strings_string_episodic_restriction	Restricted for first turn	false
random_localisation_strings_string_error_chat_command_failed	Invalid chat command	false
random_localisation_strings_string_error_chat_room_connection_failure	Chat Error||Failed to connect to chat room.	false
random_localisation_strings_string_error_chat_room_failed	Chat Error||Failed to create chat room.	false
random_localisation_strings_string_error_chat_room_invalid	Chat Error||Invalid chat room.	false
random_localisation_strings_string_error_legendary_save_load_disabled	Quick save/load is now disabled as Ironman mode is enabled	false
random_localisation_strings_string_esc_menu_concede_defeat	Concede Defeat	false
random_localisation_strings_string_esc_menu_end_trial	End Trial	false
random_localisation_strings_string_esc_menu_legendary_cannot_save	You cannot save games when playing in Ironman mode; instead, the game will automatically save during the end turn process.	false
random_localisation_strings_string_event_log_battle_defeat_close_phyrric	Valiant Defeat	false
random_localisation_strings_string_event_log_battle_defeat_heroic_crushing	Crushing Defeat	false
random_localisation_strings_string_event_log_battle_defeat_major_decisive	Decisive Defeat	false
random_localisation_strings_string_event_log_battle_defeat_minor_close	Close Defeat	false
random_localisation_strings_string_event_log_battle_draw	Draw	false
random_localisation_strings_string_event_log_battle_victory_close_phyrric	Pyrrhic Victory	false
random_localisation_strings_string_event_log_battle_victory_heroic_crushing	Heroic Victory	false
random_localisation_strings_string_event_log_battle_victory_major_decisive	Decisive Victory	false
random_localisation_strings_string_event_log_battle_victory_minor_close	Close Victory	false
random_localisation_strings_string_every_second	(every second)	false
random_localisation_strings_string_every_x_seconds	(every %ds)	false
random_localisation_strings_string_exclusive_content	[[col:yellow]] (EXCLUSIVE CONTENT)[[/col]]	false
random_localisation_strings_string_exit_theatre_tooltip	Exit theatre here	false
random_localisation_strings_string_experience	Experience	false
random_localisation_strings_string_experience_progress	Unit experience required for next rank: %d	false
random_localisation_strings_string_expert	Very Hard	false
random_localisation_strings_string_explosive	Explosive	false
random_localisation_strings_string_exporting	Exporting:	false
random_localisation_strings_string_faction_common	Common	false
random_localisation_strings_string_famous_battle_battle_of	Battle of	false
random_localisation_strings_string_famous_battle_defeated_by	Defeated by:	false
random_localisation_strings_string_famous_battle_victory_over	Victory over:	false
random_localisation_strings_string_farm	Farm	false
random_localisation_strings_string_fatigue	[[img:ui/skins/default/fatigue.png]][[/img]] Vigour per second	false
random_localisation_strings_string_fatigue_active	[[col:green]]Active[[/col]]	false
random_localisation_strings_string_fatigue_active_construct	[[col:green]]Active[[/col]]	false
random_localisation_strings_string_fatigue_active_undead	[[col:green]]Active[[/col]]	false
random_localisation_strings_string_fatigue_exhausted	[[col:red]]Exhausted[[/col]]	false
random_localisation_strings_string_fatigue_exhausted_construct	[[col:red]]Debilitated[[/col]]	false
random_localisation_strings_string_fatigue_exhausted_undead	[[col:red]]Debilitated[[/col]]	false
random_localisation_strings_string_fatigue_fresh	[[col:green]]Fresh[[/col]]	false
random_localisation_strings_string_fatigue_fresh_construct	[[col:green]]Animated[[/col]]	false
random_localisation_strings_string_fatigue_fresh_undead	[[col:green]]Animated[[/col]]	false
random_localisation_strings_string_fatigue_tired	[[col:fatigue_tired]]Tired[[/col]]	false
random_localisation_strings_string_fatigue_tired_construct	[[col:fatigue_tired]]Diminished[[/col]]	false
random_localisation_strings_string_fatigue_tired_undead	[[col:fatigue_tired]]Diminished[[/col]]	false
random_localisation_strings_string_fatigue_very_tired	[[col:red]]Very tired[[/col]]	false
random_localisation_strings_string_fatigue_very_tired_construct	[[col:red]]Drained[[/col]]	false
random_localisation_strings_string_fatigue_very_tired_undead	[[col:red]]Drained[[/col]]	false
random_localisation_strings_string_fatigue_winded	[[col:fatigue_winded]]Winded[[/col]]	false
random_localisation_strings_string_fatigue_winded_construct	[[col:fatigue_winded]]Fading[[/col]]	false
random_localisation_strings_string_fatigue_winded_undead	[[col:fatigue_winded]]Fading[[/col]]	false
random_localisation_strings_string_fe_recruitment_card_tooltip_cap_reached_land	You are unable to add anymore units of this type as you have reached the limit of %d per army.	false
random_localisation_strings_string_fe_recruitment_card_tooltip_command_clash_land	You cannot recruit this unit until you have a general in your army	false
random_localisation_strings_string_fe_recruitment_card_tooltip_land	Left-click to select.\\nRight-click for information.\\nDouble left-click or drag to force to add.	false
random_localisation_strings_string_fe_recruitment_card_tooltip_unit_group_cap_reached	It is not possible to add any more units of this category as you have reached the limit of %d per army.	false
random_localisation_strings_string_fe_unit_card_tooltip_additional_unit_caps	This unit also counts towards the following unit caps:	false
random_localisation_strings_string_fe_unit_card_tooltip_cap_land	Units of this type are capped to %d per army.	false
random_localisation_strings_string_fe_unit_card_tooltip_land	Left-click to select. \\nDouble left-click to remove.\\nRight-click for information.||Cards can be dragged to a new location to reorder them within the army.	false
random_localisation_strings_string_fe_unit_card_tooltip_minimal_land	Left-click to select. \\nRight-click for information.||Cards can be dragged to a new location to re-order them within the army.	false
random_localisation_strings_string_fe_unit_card_tooltip_no_dupe_land	Left-click to select. \\nDouble left-click to remove.||Cards can be dragged to a new location to reorder them within the army.	false
random_localisation_strings_string_fe_unit_card_tooltip_unit_caps_not_reached	The unit counts towards the following unit caps:	false
random_localisation_strings_string_fe_unit_card_tooltip_unit_caps_reached	You cannot add further units from the following sets as you have reached their cap:	false
random_localisation_strings_string_file_load_failed	Load failed	false
random_localisation_strings_string_finance_details_header_other	Other	false
random_localisation_strings_string_finance_details_tooltip_other	Any other miscellaneous sources.	false
random_localisation_strings_string_finance_header_agent_actions	[[img:icon_hero]][[/img]]Hero Actions	false
random_localisation_strings_string_finance_header_building_upkeep	Building upkeep	false
random_localisation_strings_string_finance_header_civic	Civic	false
random_localisation_strings_string_finance_header_commerce_raiding	Raiding	false
random_localisation_strings_string_finance_header_construction	Construction	false
random_localisation_strings_string_finance_header_diplomacy	Diplomacy	false
random_localisation_strings_string_finance_header_expenses	Expenses	false
random_localisation_strings_string_finance_header_fleet_upkeep	Fleet Upkeep	false
random_localisation_strings_string_finance_header_income	Income	false
random_localisation_strings_string_finance_header_liege_lord	Master	false
random_localisation_strings_string_finance_header_looting	Looting	false
random_localisation_strings_string_finance_header_military	Military	false
random_localisation_strings_string_finance_header_mines	Mines	false
random_localisation_strings_string_finance_header_other	Background income	false
random_localisation_strings_string_finance_header_payload	Event Outcomes	false
random_localisation_strings_string_finance_header_postbattle_loot	Post-Battle Loot	false
random_localisation_strings_string_finance_header_raided	Raiding	false
random_localisation_strings_string_finance_header_ransom_battle_captive	[PLACEHOLDER]	false
random_localisation_strings_string_finance_header_ransom_battle_captives	Captives	false
random_localisation_strings_string_finance_header_recruitment	Recruitment	false
random_localisation_strings_string_finance_header_taxes	{{tr:taxes}}	false
random_localisation_strings_string_finance_header_total_expenses	Total Expenses	false
random_localisation_strings_string_finance_header_total_income	Total Income	false
random_localisation_strings_string_finance_header_total_upkeep	Total Upkeep	false
random_localisation_strings_string_finance_header_trade	Trade	false
random_localisation_strings_string_finance_header_tribute	Tribute	false
random_localisation_strings_string_finance_header_unit_upkeep	Unit Upkeep	false
random_localisation_strings_string_finance_header_upkeep	Upkeep	false
random_localisation_strings_string_finance_header_vassals	Vassals	false
random_localisation_strings_string_finance_tooltip_agent_actions	Expenses on covert actions initiated by your [[img:icon_hero]][[/img]]Heroes.	false
random_localisation_strings_string_finance_tooltip_building_upkeep	Expenses on maintaining buildings.	false
random_localisation_strings_string_finance_tooltip_commerce_raiding	Income from armies using [[img:icon_raiding_stance]][[/img]]Raiding stance.	false
random_localisation_strings_string_finance_tooltip_construction	Expenses on constructing and upgrading buildings.	false
random_localisation_strings_string_finance_tooltip_liege_lord	Expenses paid to your master of which you are a vassal.	false
random_localisation_strings_string_finance_tooltip_looting	Income from plundering settlements.	false
random_localisation_strings_string_finance_tooltip_other	Income from other sources.	false
random_localisation_strings_string_finance_tooltip_payload	Income from missions, random incidents and dilemmas.	false
random_localisation_strings_string_finance_tooltip_postbattle_loot	Income from winning battles.	false
random_localisation_strings_string_finance_tooltip_raided	Income lost from enemy armies using [[img:icon_raiding_stance]][[/img]]Raiding stance.	false
random_localisation_strings_string_finance_tooltip_ransom_battle_captives	Income from ransoming captives.	false
random_localisation_strings_string_finance_tooltip_recruitment	Expenses on recruiting new units.	false
random_localisation_strings_string_finance_tooltip_taxes	Income from buildings.	false
random_localisation_strings_string_finance_tooltip_trade	Income from trade agreements made with other factions.	false
random_localisation_strings_string_finance_tooltip_tribute	Expenses on tributes paid to other factions.	false
random_localisation_strings_string_finance_tooltip_unit_upkeep	Expenses on maintaining units.	false
random_localisation_strings_string_finance_tooltip_vassals	Income from factions that are your vassals.	false
random_localisation_strings_string_finances_background_income	Base income	false
random_localisation_strings_string_finances_commerce_raiding_income	From trade route raiding	false
random_localisation_strings_string_finances_other_income	Income from other sources.	false
random_localisation_strings_string_finances_tribute_expenditure	To others	false
random_localisation_strings_string_finances_tribute_expenditure_breakdown_faction	%S (turns remaining %d)	false
random_localisation_strings_string_finances_vassal_income	Total from vassals	false
random_localisation_strings_string_finances_vassal_income_breakdown_faction	%S	false
random_localisation_strings_string_find_match	Find Match	false
random_localisation_strings_string_fire_damage	[[img:ui/skins/default/modifier_icon_flaming.png]][[/img]]Fire Damage	false
random_localisation_strings_string_flaming_imbuement	Flaming Attacks	false
random_localisation_strings_string_fleet_status_transit1	In transit	false
random_localisation_strings_string_fleet_status_transit2	En route to:	false
random_localisation_strings_string_food_breakdown	{{tr:food_breakdown_header}}	false
random_localisation_strings_string_food_consumption	Consumption	false
random_localisation_strings_string_food_percent	Production percent	false
random_localisation_strings_string_food_production	Production	false
random_localisation_strings_string_forbidden_knowledge_points	Forbidden Knowledge	false
random_localisation_strings_string_form_tooltip_bulletpoint	Transforms into: %s	false
random_localisation_strings_string_formatted_minutes_plural	%d minutes	false
random_localisation_strings_string_fortification	Fortification	false
random_localisation_strings_string_free_content	[[col:yellow]] (FREE CONTENT)[[/col]]	false
random_localisation_strings_string_friendly	Friendly	false
random_localisation_strings_string_friends	Friends	false
random_localisation_strings_string_frontend_theme_MAIN_MENU_THEME	{{tr:ownership_products_description_TW_WH3_BASE_GAME}}	false
random_localisation_strings_string_frontend_theme_TW_WH2_BASE_THEME	{{tr:ownership_products_description_TW_WH2_BASE_GAME}}	false
random_localisation_strings_string_frontend_theme_TW_WH2_DLC10_QUEEN_CRONE_THEME	{{tr:ownership_products_description_TW_WH2_BASE_GAME}} – {{tr:ownership_products_description_TW_WH2_DLC10_QUEEN_CRONE}}	false
random_localisation_strings_string_frontend_theme_TW_WH2_DLC11_VAMPIRE_COAST_THEME	{{tr:ownership_products_description_TW_WH2_BASE_GAME}} – {{tr:ownership_products_description_TW_WH2_DLC11_VAMPIRE_COAST}}	false
random_localisation_strings_string_frontend_theme_TW_WH2_DLC12_PROPHET_THEME	{{tr:ownership_products_description_TW_WH2_BASE_GAME}} – {{tr:ownership_products_description_TW_WH2_DLC12_PROPHET}}	false
random_localisation_strings_string_frontend_theme_TW_WH2_DLC13_HUNTER_THEME	{{tr:ownership_products_description_TW_WH2_BASE_GAME}} – {{tr:ownership_products_description_TW_WH2_DLC13_HUNTER}}	false
random_localisation_strings_string_frontend_theme_TW_WH2_DLC14_SHADOW_THEME	{{tr:ownership_products_description_TW_WH2_BASE_GAME}} – {{tr:ownership_products_description_TW_WH2_DLC14_SHADOW}}	false
random_localisation_strings_string_frontend_theme_TW_WH2_DLC15_WARDEN_THEME	{{tr:ownership_products_description_TW_WH2_BASE_GAME}} – {{tr:ownership_products_description_TW_WH2_DLC15_WARDEN}}	false
random_localisation_strings_string_frontend_theme_TW_WH2_DLC16_TWILIGHT_THEME	{{tr:ownership_products_description_TW_WH2_BASE_GAME}} – {{tr:ownership_products_description_TW_WH2_DLC16_TWILIGHT}}	false
random_localisation_strings_string_frontend_theme_TW_WH2_DLC17_SILENCE_THEME	{{tr:ownership_products_description_TW_WH2_BASE_GAME}} – {{tr:ownership_products_description_TW_WH2_DLC17_SILENCE}}	false
random_localisation_strings_string_frontend_theme_TW_WH2_TOMB_KINGS_THEME	{{tr:ownership_products_description_TW_WH2_BASE_GAME}} – {{tr:ownership_products_description_TW_WH2_TOMB_KINGS}}	false
random_localisation_strings_string_frontend_theme_TW_WH3_CHAOS_DWARFS_THEME	{{tr:ownership_products_description_TW_WH3_BASE_GAME}} – {{tr:ownership_products_description_TW_WH3_CHAOS_DWARFS}}	false
random_localisation_strings_string_frontend_theme_TW_WH3_DLC20_CHAMPIONS_THEME	{{tr:ownership_products_description_TW_WH3_BASE_GAME}} – {{tr:ownership_products_description_TW_WH3_DLC20_CHAMPIONS}}	false
random_localisation_strings_string_frontend_theme_TW_WH3_MIRROR_THEME	{{tr:ownership_products_description_TW_WH3_BASE_GAME}} – {{tr:random_localisation_strings_string_mirror_of_madness}}	false
random_localisation_strings_string_frontend_theme_TW_WH3_OMENS_OF_DESTRUCTION	{{tr:ownership_products_description_TW_WH3_BASE_GAME}} – Omens of Destruction	false
random_localisation_strings_string_frontend_theme_TW_WH3_SHADOWS_OF_CHANGE_THEME	{{tr:ownership_products_description_TW_WH3_BASE_GAME}} – {{tr:ownership_products_description_TW_WH3_SHADOWS_OF_CHANGE}}	false
random_localisation_strings_string_frontend_theme_TW_WH3_THRONES_OF_DECAY_THEME	{{tr:ownership_products_description_TW_WH3_BASE_GAME}} – Thrones of Decay	false
random_localisation_strings_string_frontend_theme_TW_WH_BASE_THEME	{{tr:ownership_products_description_TW_WH1_BASE_GAME}}	false
random_localisation_strings_string_frontend_theme_TW_WH_BEASTMEN	{{tr:ownership_products_description_TW_WH1_BASE_GAME}} – {{tr:ownership_products_description_TW_WH1_BEASTMEN}}	false
random_localisation_strings_string_frontend_theme_TW_WH_BLOODPACK	{{tr:ownership_products_description_TW_WH1_BASE_GAME}} – {{tr:ownership_products_description_TW_WH3_BLOODPACK}}	false
random_localisation_strings_string_frontend_theme_TW_WH_BRETONNIA_FREE	{{tr:ownership_products_description_TW_WH1_BASE_GAME}} – {{tr:ownership_products_description_TW_WH1_BRETONNIA_FREE}}	false
random_localisation_strings_string_frontend_theme_TW_WH_LORDS_AND_UNITS_1	{{tr:ownership_products_description_TW_WH1_BASE_GAME}} – {{tr:ownership_products_description_TW_WH1_LORDS_AND_UNITS_1}}	false
random_localisation_strings_string_frontend_theme_TW_WH_LORDS_AND_UNITS_2	{{tr:ownership_products_description_TW_WH1_BASE_GAME}} – {{tr:ownership_products_description_TW_WH1_LORDS_AND_UNITS_2}}	false
random_localisation_strings_string_frontend_theme_TW_WH_NORSCA	{{tr:ownership_products_description_TW_WH1_BASE_GAME}} – {{tr:ownership_products_description_TW_WH1_NORSCA}}	false
random_localisation_strings_string_frontend_theme_TW_WH_TWA_03_RAKARTH_THEME	{{tr:ownership_products_description_TW_WH2_BASE_GAME}} – {{tr:ownership_products_description_TW_WH2_TWA_03_RAKARTH}}	false
random_localisation_strings_string_frontend_theme_TW_WH_WOOD_ELVES	{{tr:ownership_products_description_TW_WH1_BASE_GAME}} – {{tr:ownership_products_description_TW_WH1_WOOD_ELVES}}	false
random_localisation_strings_string_full	Full	false
random_localisation_strings_string_function_building_upgrade_hud	Left-click to order upgrade, right-click for further information.	false
random_localisation_strings_string_function_construction_hud	Left-click to select, right-click for further information.	false
random_localisation_strings_string_game_aborted	Game aborted	false
random_localisation_strings_string_gate_with_oil	(with oil)	false
random_localisation_strings_string_general_name_not_set	[[col:red]]The Legendary Lord's name must be set before starting the campaign.[[/col]]	false
random_localisation_strings_string_gfx_aa_16x16	16x	false
random_localisation_strings_string_gfx_aa_2x2	2x	false
random_localisation_strings_string_gfx_aa_4x4	4x	false
random_localisation_strings_string_gfx_aa_8x8	8x	false
random_localisation_strings_string_gfx_aa_fxaa	FXAA	false
random_localisation_strings_string_gfx_aa_mlaa	FXAA	false
random_localisation_strings_string_gfx_aa_taa	TAA	false
random_localisation_strings_string_gfx_aa_taa_high	TAA High	false
random_localisation_strings_string_gfx_custom	Customised	false
random_localisation_strings_string_gfx_downgraded	WARNING! Graphics memory is running low. The graphics are being downgraded for this session. You can tick the “unlimited video memory” box in advanced graphics options to override the downgrade by using system memory for graphics, but slowdowns may happen if you don’t have much system memory. If that happens, un-tick the box and reduce the texture quality setting.	false
random_localisation_strings_string_gfx_drop_low	Low	false
random_localisation_strings_string_gfx_drop_ultra	Ultra	false
random_localisation_strings_string_gfx_extreme	Extreme	false
random_localisation_strings_string_gfx_filtering_ani16x	Anisotropic 16x	false
random_localisation_strings_string_gfx_filtering_ani2x	Anisotropic 2x	false
random_localisation_strings_string_gfx_filtering_ani4x	Anisotropic 4x	false
random_localisation_strings_string_gfx_filtering_ani8x	Anisotropic 8x	false
random_localisation_strings_string_gfx_filtering_bi	Bilinear	false
random_localisation_strings_string_gfx_filtering_tri	Trilinear	false
random_localisation_strings_string_gfx_high	High	false
random_localisation_strings_string_gfx_low	Low	false
random_localisation_strings_string_gfx_med	Medium	false
random_localisation_strings_string_gfx_off	Off	false
random_localisation_strings_string_gfx_on	On	false
random_localisation_strings_string_gfx_ultra	Ultra	false
random_localisation_strings_string_gfx_v_high	Very High	false
random_localisation_strings_string_go_to_store_epic	Go to store page	false
random_localisation_strings_string_go_to_store_gdk	Go to Microsoft Store	false
random_localisation_strings_string_go_to_store_steam	Go to store page	false
random_localisation_strings_string_grand_campaign_dlc_warning	In order to play the Mortal Empires campaign, you must have Total War: WARHAMMER in your Steam library. 	false
random_localisation_strings_string_graphics_settings_require_restart	The new settings will be applied once the game has been re-started.	false
random_localisation_strings_string_ground	Ground	false
random_localisation_strings_string_ground_type_modifier	Terrain	false
random_localisation_strings_string_growth_rate	Growth per turn	false
random_localisation_strings_string_guerrilla_cant_deploy	Only [[img:vanguard]][[/img]]vanguard units can deploy outside your army's deployment area.	false
random_localisation_strings_string_gunners	text_rejected	false
random_localisation_strings_string_happy	Happy	false
random_localisation_strings_string_hard	Hard	false
random_localisation_strings_string_heir	Heir	false
random_localisation_strings_string_help_pages_expand_racial_mechanics	Race-Specific Mechanics	false
random_localisation_strings_string_help_pages_expand_warhammer_1_races	Warhammer 1	false
random_localisation_strings_string_help_pages_expand_warhammer_2_races	Warhammer 2	false
random_localisation_strings_string_help_pages_expand_warhammer_3_races	Warhammer 3	false
random_localisation_strings_string_hidden	???	false
random_localisation_strings_string_hide_dead_bodies_permanent	Permanent	false
random_localisation_strings_string_high	High	false
random_localisation_strings_string_highlight_text_unit_caps	This is the placeholder unit caps highlight text. If this is still here see Sean Macdonald.	false
random_localisation_strings_string_highlight_text_unit_upgrade_selection	New to Total War: WARHAMMER II, some characters have a selection of mounts and upgrades available to them. Selecting these icons will assign the chosen mount and upgrades for the battle ahead.	false
random_localisation_strings_string_hitpoints_replenishment_per_turn	[[img:icon_hp]][[/img]]Hit points replenished per turn: 	false
random_localisation_strings_string_hits_1_entity	Affects 1 Entity	false
random_localisation_strings_string_hits_n_entities	Affects %d Entities	false
random_localisation_strings_string_hudbutton_studying_name	Studying:	false
random_localisation_strings_string_hudbutton_studying_turns_until_completion	Turns until completion:	false
random_localisation_strings_string_imbued_effects	Imbued	false
random_localisation_strings_string_imperium	Imperium	false
random_localisation_strings_string_importing	Importing	false
random_localisation_strings_string_incompatible_version	Host's game version differs from yours, you will not be able to join this game	false
random_localisation_strings_string_increase_experience	Increase experience	false
random_localisation_strings_string_increasing	Improving	false
random_localisation_strings_string_indestructible	Indestructible	false
random_localisation_strings_string_influence	Influence:	false
random_localisation_strings_string_ingame_messaging_offline_body	You can still experience offline features.\\nTo experience all features of Total War: WARHAMMER III please connect to the internet.	false
random_localisation_strings_string_ingame_messaging_offline_bottom	If you need assistance, please visit the support page: https://www.totalwar.com/support	false
random_localisation_strings_string_ingame_messaging_offline_title	YOU APPEAR TO BE OFFLINE	false
random_localisation_strings_string_invalid_army_setup_alliance	A player has an invalid army setup	false
random_localisation_strings_string_invalid_army_setup_local	Your army setup is invalid.	false
random_localisation_strings_string_invalid_spell_target	[[col:red]]Invalid target.[[/col]]Valid targets: 	false
random_localisation_strings_string_invalid_spell_target_too_close	[[col:red]]Target too close.[[/col]]	false
random_localisation_strings_string_ironman_mode_warning	[[col:red]]Manual saves are not allowed during a campaign. [[/col]]	false
random_localisation_strings_string_ironman_tooltip	Ironman mode will remove the ability to manually save the game.	false
random_localisation_strings_string_land_combatant_even	combat even	false
random_localisation_strings_string_land_combatant_losing	Unit losing	false
random_localisation_strings_string_land_combatant_losing_big	Unit losing decisively	false
random_localisation_strings_string_land_combatant_losing_slightly	Unit losing slightly	false
random_localisation_strings_string_land_combatant_winning	Unit winning	false
random_localisation_strings_string_land_combatant_winning_big	Unit winning decisively	false
random_localisation_strings_string_land_combatant_winning_slightly	Unit winning slightly	false
random_localisation_strings_string_land_not_in_combat	Not in combat	false
random_localisation_strings_string_large	Large	false
random_localisation_strings_string_large_entity	{{tr:uied_component_texts_localised_string_dy_men_large_Tooltip_1f001c}}	false
random_localisation_strings_string_large_entity_campaign	{{tr:uied_component_texts_localised_string_dy_men_large_Tooltip_1f001c}}	false
random_localisation_strings_string_late	Late	false
random_localisation_strings_string_left_click_bb	Left-click to view in Building Browser.	false
random_localisation_strings_string_left_click_copy_text	Left-click to copy message	false
random_localisation_strings_string_left_click_pin	\\nLeft-click to pin info panel	false
random_localisation_strings_string_level_level_level_level	Level	false
random_localisation_strings_string_limited	Limited	false
random_localisation_strings_string_load_campaign	Load Campaign Game	false
random_localisation_strings_string_load_character_disabled	Loading characters has been disabled for this battle. This can be enabled in map setup by the host.	false
random_localisation_strings_string_load_fail	Load failed	false
random_localisation_strings_string_load_hero	Load Hero	false
random_localisation_strings_string_load_lab_settings	Load Settings	false
random_localisation_strings_string_load_lord	Load Lord	false
random_localisation_strings_string_load_preset	Load Preset	false
random_localisation_strings_string_load_success	Load succeeded	false
random_localisation_strings_string_loaded_character	This unit is a loaded character	false
random_localisation_strings_string_lock_race	Lock in Race	false
random_localisation_strings_string_locked_slot_requires_castle_upgrade	text_rejected	false
random_localisation_strings_string_low	Low	false
random_localisation_strings_string_magic_damage	[[img:ui/skins/default/modifier_icon_magical.png]][[/img]]Magical Damage	false
random_localisation_strings_string_main_army	Main Army	false
random_localisation_strings_string_map_wide	Map-wide	false
random_localisation_strings_string_marked_for_dismantling	Marked for demolishing	false
random_localisation_strings_string_mass	Mass	false
random_localisation_strings_string_matchmaking_select_mode	[[col:red]]You must select a game mode before searching for a match[[/col]]	false
random_localisation_strings_string_max_units	max:	false
random_localisation_strings_string_medium	Medium	false
random_localisation_strings_string_melee_attack	Melee Attack	false
random_localisation_strings_string_melee_defence	Melee Defence	false
random_localisation_strings_string_metre_abbreviation	m	false
random_localisation_strings_string_metres_per_second_abbreviation	m/s	false
random_localisation_strings_string_midday	Mid-day	false
random_localisation_strings_string_military_force_legacy_name_garrison_army	Garrison Army	false
random_localisation_strings_string_military_force_legacy_name_garrison_navy	Garrison Fleet	false
random_localisation_strings_string_military_force_legacy_name_pirate_navy	Pirate Fleet	false
random_localisation_strings_string_military_force_legacy_name_prefix_army	Legio	false
random_localisation_strings_string_military_force_legacy_name_prefix_navy	Classis	false
random_localisation_strings_string_military_force_legacy_name_rebel_army	Rebel Army	false
random_localisation_strings_string_military_force_legacy_name_transport_fleet	Transport Fleet	false
random_localisation_strings_string_mirror_of_madness	Mirror of Madness	false
random_localisation_strings_string_miscast	Miscast chance	false
random_localisation_strings_string_miscast_tooltip	There is a chance that when an upgrade spell is cast, a miscast will occur, damaging the caster.	false
random_localisation_strings_string_missile_damage_time_explanation	\\n\\nDamage value shown is damage over %u seconds	false
random_localisation_strings_string_missing_content_for_load	You cannot load this save game. You require DLC to access the following faction: %s	false
random_localisation_strings_string_missing_mods	You cannot load this save game. You are missing the following mods:\\n\\n	false
random_localisation_strings_string_modifier_icon_tooltip_armour_piercing	Armour Piercing||The damage of armour-piercing weapons mostly ignores the target's armour, making them the ideal choice against heavily-armoured enemies. They often inflict less damage in total though, making them less efficient against weakly armoured targets.	false
random_localisation_strings_string_modifier_icon_tooltip_bonus_vs_infantry	Bonus vs. Infantry||This unit inflicts additional damage and has an increased chance of a hit when fighting enemies that are man-sized or smaller.	false
random_localisation_strings_string_modifier_icon_tooltip_bonus_vs_large	Bonus vs. Large||This unit inflicts additional damage and has an increased chance of hitting enemies that are cavalry-sized or larger.	false
random_localisation_strings_string_modifier_icon_tooltip_directional_shield	Directional Shield||This unit has a 360 degree [[img:ui/skins/default/modifier_icon_directional_shield.png]][[/img]]Directional Shield which blocks small arms missile fire based on which side the unit has been hit from:\\n\\nThe [[b]][[col:white]][[img:icon_missile_block_chance]][[/img]] Missile Block Chance[[/col]][[/b]] of each side is:\\n[[img:icon_shield_gold]][[/img]]%d%% at the front\\n[[img:icon_shield_silver]][[/img]]%d%% at the sides\\n[[img:icon_shield_bronze]][[/img]]%d%% at the rear	false
random_localisation_strings_string_modifier_icon_tooltip_flaming	Flaming Attacks||This unit inflicts flaming attacks. Units hit by flaming attacks heal at half the usual rate whilst [[img:UI/skins/default/modifier_icon_flaming.png]][[/img]] 'on fire’ and sustain additional damage if vulnerable to fire. \\n It also adds a [[img:ui/skins/default/weapon_building_damage_modifier.png]][[/img]] [[col:green]]+50%[[/col]] damage multiplier against buildings.	false
random_localisation_strings_string_modifier_icon_tooltip_magical	Magical Attacks||This unit inflicts magical attacks which can harm units that are protected from regular physical attacks.	false
random_localisation_strings_string_modifier_icon_tooltip_shield	Shielded||This unit has a shield and will block %d%% of all small-arms missile fire hitting it from the front.	false
random_localisation_strings_string_morale	{{tr:morale}}	false
random_localisation_strings_string_morale_0	[[col:red]]Deserting[[/col]]	false
random_localisation_strings_string_morale_1	[[col:red]]Deserting[[/col]]	false
random_localisation_strings_string_morale_20	[[col:red]]Disparate[[/col]]	false
random_localisation_strings_string_morale_40	[[col:green]]Amassing[[/col]]	false
random_localisation_strings_string_morale_60	[[col:green]]The Raucous Host![[/col]]	false
random_localisation_strings_string_morale_80	[[col:green]]The Raucous Host![[/col]]	false
random_localisation_strings_string_morale_amok	[[col:red]]Running Amok[[/col]]	false
random_localisation_strings_string_morale_broken	[[col:red]]Broken[[/col]]	false
random_localisation_strings_string_morale_broken_bound_fire_daemon	[[col:red]]Unstable[[/col]]	false
random_localisation_strings_string_morale_broken_construct	[[col:red]]Crumbling[[/col]]	false
random_localisation_strings_string_morale_broken_daemonic	[[col:red]]Unstable[[/col]]	false
random_localisation_strings_string_morale_broken_elemental	[[col:red]]Unstable[[/col]]	false
random_localisation_strings_string_morale_broken_undead	[[col:red]]Crumbling[[/col]]	false
random_localisation_strings_string_morale_confident	[[col:green]]{{tr:confident}}[[/col]]	false
random_localisation_strings_string_morale_confident_bound_fire_daemon	[[col:green]]{{tr:confident_daemonic}}[[/col]]	false
random_localisation_strings_string_morale_confident_construct	[[col:green]]{{tr:confident_undead}}[[/col]]	false
random_localisation_strings_string_morale_confident_daemonic	[[col:green]]{{tr:confident_daemonic}}[[/col]]	false
random_localisation_strings_string_morale_confident_elemental	[[col:green]]{{tr:confident_daemonic}}[[/col]]	false
random_localisation_strings_string_morale_confident_undead	[[col:green]]{{tr:confident_undead}}[[/col]]	false
random_localisation_strings_string_morale_eager	[[col:green]]Eager[[/col]]	false
random_localisation_strings_string_morale_eager_bound_fire_daemon	[[col:green]]Eager[[/col]]	false
random_localisation_strings_string_morale_eager_construct	[[col:green]]Strong Binding[[/col]]	false
random_localisation_strings_string_morale_eager_daemonic	[[col:green]]Eager[[/col]]	false
random_localisation_strings_string_morale_eager_elemental	[[col:green]]Eager[[/col]]	false
random_localisation_strings_string_morale_eager_undead	[[col:green]]Strong Binding[[/col]]	false
random_localisation_strings_string_morale_fighting_to_death	[[col:red]]Fighting to the death[[/col]]	false
random_localisation_strings_string_morale_impetuous	[[col:green]]Impetuous[[/col]]	false
random_localisation_strings_string_morale_impetuous_bound_fire_daemon	[[col:green]]Impetuous[[/col]]	false
random_localisation_strings_string_morale_impetuous_construct	[[col:green]]Impetuous[[/col]]	false
random_localisation_strings_string_morale_impetuous_daemonic	[[col:green]]Impetuous[[/col]]	false
random_localisation_strings_string_morale_impetuous_elemental	[[col:green]]Impetuous[[/col]]	false
random_localisation_strings_string_morale_impetuous_undead	[[col:green]]Impetuous[[/col]]	false
random_localisation_strings_string_morale_routing	[[col:red]]Routing[[/col]]	false
random_localisation_strings_string_morale_routing_daemonic	[[col:red]]Unstable[[/col]]	false
random_localisation_strings_string_morale_routing_elemental	[[col:red]]Unstable[[/col]]	false
random_localisation_strings_string_morale_shaken	[[col:red]]Shaken[[/col]]	false
random_localisation_strings_string_morale_shaken_bound_fire_daemon	[[col:red]]Shaken[[/col]]	false
random_localisation_strings_string_morale_shaken_construct	[[col:red]]Weak Binding[[/col]]	false
random_localisation_strings_string_morale_shaken_daemonic	[[col:red]]Shaken[[/col]]	false
random_localisation_strings_string_morale_shaken_elemental	[[col:red]]Shaken[[/col]]	false
random_localisation_strings_string_morale_shaken_undead	[[col:red]]Weak Binding[[/col]]	false
random_localisation_strings_string_morale_shattered	[[col:red]]Shattered[[/col]]	false
random_localisation_strings_string_morale_shattered_bound_fire_daemon	[[col:red]]Shattered[[/col]]	false
random_localisation_strings_string_morale_shattered_construct	[[col:red]]Disintegrating[[/col]]	false
random_localisation_strings_string_morale_shattered_daemonic	[[col:red]]Banished[[/col]]	false
random_localisation_strings_string_morale_shattered_elemental	[[col:red]]Banished[[/col]]	false
random_localisation_strings_string_morale_shattered_undead	[[col:red]]Disintegrating[[/col]]	false
random_localisation_strings_string_morale_steady	[[col:green]]{{tr:steady}}[[/col]]	false
random_localisation_strings_string_morale_steady_bound_fire_daemon	[[col:green]]{{tr:steady_daemonic}}[[/col]]	false
random_localisation_strings_string_morale_steady_construct	[[col:green]]{{tr:steady_undead}}[[/col]]	false
random_localisation_strings_string_morale_steady_daemonic	[[col:green]]{{tr:steady_daemonic}}[[/col]]	false
random_localisation_strings_string_morale_steady_elemental	[[col:green]]{{tr:steady_daemonic}}[[/col]]	false
random_localisation_strings_string_morale_steady_undead	[[col:green]]{{tr:steady_undead}}[[/col]]	false
random_localisation_strings_string_morale_surrendered	[[col:red]]Surrendered[[/col]]	false
random_localisation_strings_string_morale_turn_until_rebellion	At the current rate of decline, this army will rebel in %n turns.	false
random_localisation_strings_string_morale_waagh	{{tr:morale_waaagh}}	false
random_localisation_strings_string_morale_waagh_army_tooltip	{{tr:morale_waagh_army_tooltip}}	false
random_localisation_strings_string_morale_wavering	[[col:red]]{{tr:wavering}}[[/col]]	false
random_localisation_strings_string_morale_wavering_bound_fire_daemon	[[col:red]]{{tr:wavering_bound_fire_daemon}}[[/col]]	false
random_localisation_strings_string_morale_wavering_construct	[[col:red]]{{tr:wavering_undead}}[[/col]]	false
random_localisation_strings_string_morale_wavering_daemonic	[[col:red]]{{tr:wavering_daemonic}}[[/col]]	false
random_localisation_strings_string_morale_wavering_elemental	[[col:red]]{{tr:wavering_daemonic}}[[/col]]	false
random_localisation_strings_string_morale_wavering_undead	[[col:red]]{{tr:wavering_undead}}[[/col]]	false
random_localisation_strings_string_mouse_over	Mouse-over	false
random_localisation_strings_string_move_options_multiplayer_cannot_declare_war	You cannot declare war against your multiplayer co-op partner.	false
random_localisation_strings_string_move_options_vassal_cannot_declare_war	text_rejected	false
random_localisation_strings_string_mp_coop_partner_defeated	Your co-op partner has been defeated, the game will end now.	false
random_localisation_strings_string_mp_options_simultaneous_turns_active_tooltip	Members of each team will take their turns simultaneously	false
random_localisation_strings_string_mp_options_simultaneous_turns_inactive_tooltip	To change this setting you must have multiple teams where at least one has multiple players	false
random_localisation_strings_string_mp_players_preventing_ready_up	Players preventing ready up:	false
random_localisation_strings_string_mp_players_preventing_ready_up_list_entry	\\n[[img:ui/skins/default/fe_news_navigation.png]][[/img]] %s	false
random_localisation_strings_string_mp_ready	Ready	false
random_localisation_strings_string_mp_ready_error_ai_invalid_army_index	[[col:red]]An AI player has been assigned an army that is already taken. Please assign it another before declaring readiness.[[/col]]	false
random_localisation_strings_string_mp_ready_error_ai_no_siege_units	[[col:red]]AI players must have some infantry or artillery units capable of assaulting fortifications.[[/col]]	false
random_localisation_strings_string_mp_ready_error_army_no_capture_units	[[col:red]]Army has no units that can capture victory points[[/col]]	false
random_localisation_strings_string_mp_ready_error_battle_type_desync	[[col:red]]The battle type selected doesn't match the map selected.[[/col]]	false
random_localisation_strings_string_mp_ready_error_campaign_team_incompatible_faction	[[col:red]]Your selected faction can not be on the same team as the following factions currently in this team:[[/col]]	false
random_localisation_strings_string_mp_ready_error_compatible_factions_for_team	\\n\\n[[col:red]]These are the factions that are valid for you to select to be on this team currently:[[/col]]	false
random_localisation_strings_string_mp_ready_error_empty_player_slot	[[col:red]]You cannot start the game with an empty player slot[[/col]]	false
random_localisation_strings_string_mp_ready_error_faction_defeated	[[col:red]] A player has selected a faction which has been defeated. Campaign games cannot be resumed with a defeated faction.[[/col]]	false
random_localisation_strings_string_mp_ready_error_faction_duplicates	[[col:red]]Multiple players have the same faction selected. All faction selections must be unique.[[/col]]	false
random_localisation_strings_string_mp_ready_error_faction_not_compatible_with_campaign_type	[[col:red]]A player has selected a faction that cannot participate in this campaign type. All faction selections must be able to play the campaign.[[/col]]	false
random_localisation_strings_string_mp_ready_error_ffa_needs_4_teams	[[col:red]]Free-For-All requires 4 teams[[/col]]	false
random_localisation_strings_string_mp_ready_error_human_player_needed	[[col:red]]You must have at least one human player involved in the battle.[[/col]]	false
random_localisation_strings_string_mp_ready_error_invalid_army_index	[[col:red]]The selected army is already taken. Please select another before declaring readiness.[[/col]]	false
random_localisation_strings_string_mp_ready_error_loaded_character	[[col:red]]You cannot declare readiness as your army containes a loaded character. Loading characters has been disabled for this battle.[[/col]]	false
random_localisation_strings_string_mp_ready_error_local_army_unit_count_exceeds_limit	[[col:red]]You cannot declare readiness as you have too many units for this battle.[[/col]]	false
random_localisation_strings_string_mp_ready_error_lord_cap_exceeded	[[col:red]]You cannot declare readiness as your army has more than one Lord.[[/col]]	false
random_localisation_strings_string_mp_ready_error_no_ai_faction	[[col:red]]AI faction not set[[/col]]	false
random_localisation_strings_string_mp_ready_error_no_ai_units	[[col:red]]You must select units for the AI armies before declaring readiness.[[/col]]	false
random_localisation_strings_string_mp_ready_error_no_commander	[[col:red]]You must add a Lord before starting the battle.	false
random_localisation_strings_string_mp_ready_error_no_faction	[[col:red]]Player faction set[[/col]]	false
random_localisation_strings_string_mp_ready_error_no_map_selected	[[col:red]]No map has been selected[[/col]]	false
random_localisation_strings_string_mp_ready_error_no_opposition	[[col:red]]You cannot declare ready as you have no opposition[[/col]]	false
random_localisation_strings_string_mp_ready_error_no_reinforcing_units	[[col:red]]You must select some reinforcing units.[[/col]]	false
random_localisation_strings_string_mp_ready_error_no_siege_units	[[col:red]]You must select some infantry or artillery units capable of assaulting fortifications.[[/col]]	false
random_localisation_strings_string_mp_ready_error_no_units	[[col:red]]You must select some units before declaring readiness.[[/col]]	false
random_localisation_strings_string_mp_ready_error_overspend	[[col:red]]Unable to declare readiness as a player has spent too much on their army setup.[[/col]]	false
random_localisation_strings_string_mp_ready_error_spectator	[[col:red]]You cannot ready up as a spectator, you must wait for the participating players.[[/col]]	false
random_localisation_strings_string_mp_ready_error_team_has_no_players	[[col:red]]You cannot declare ready as there are not enough players to begin this battle.[[/col]]	false
random_localisation_strings_string_mp_ready_error_too_many_armies	[[col:red]]You cannot declare readiness as there are too many players for the selected map.\\nEither change the map or remove some players.[[/col]]	false
random_localisation_strings_string_mp_ready_error_unit_caps_exceeded	[[col:red]]You cannot declare readiness as your army exceeds the unit caps.[[/col]]	false
random_localisation_strings_string_mp_sandbox_realm_of_chaos_campaign	The Realm of Chaos (Sandbox)	false
random_localisation_strings_string_multiplayer_play_battle	Play Battle	false
random_localisation_strings_string_multiplayer_time_up	You have run out of time and your turn is over.	false
random_localisation_strings_string_multiplayer_time_up_title	Time's up!	false
random_localisation_strings_string_multiplayer_waiting_reconnect	Waiting for players...	false
random_localisation_strings_string_must_negotiate_with_master	Can only request this action through this faction's master: 	false
random_localisation_strings_string_nearby_allies	Affects allies in range	false
random_localisation_strings_string_nearby_enemies	Affects enemies in range	false
random_localisation_strings_string_network_error_authentication_failed	You are not authorised to play	false
random_localisation_strings_string_network_error_campaign_map_not_owned	You cannot join this game as the host does not have permission to play on this map.	false
random_localisation_strings_string_network_error_desync	There was a desync in the game, exiting...	false
random_localisation_strings_string_network_error_dlc_not_owned	You cannot join this game as you do not own the necessary content.	false
random_localisation_strings_string_network_error_dropped	You have lost connection to the game. 	false
random_localisation_strings_string_network_error_host	Failed to host game	false
random_localisation_strings_string_network_error_host_disconnected	The host has left the game	false
random_localisation_strings_string_network_error_host_failed	Failed to host game	false
random_localisation_strings_string_network_error_incompatible_data	Incompatible data	false
random_localisation_strings_string_network_error_incompatible_exe	Incompatible executable version	false
random_localisation_strings_string_network_error_incompatible_map_version	Incorrect version of map	false
random_localisation_strings_string_network_error_incompatible_missing_map	Map not found	false
random_localisation_strings_string_network_error_incompatible_mod	Incompatible mod version	false
random_localisation_strings_string_network_error_internal_controller_disconnection	There is a disconnection to the online service	false
random_localisation_strings_string_network_error_join_failed	Failed to join the selected game	false
random_localisation_strings_string_network_error_join_failed_closed_game	Failed to join game: Game in progress	false
random_localisation_strings_string_network_error_join_failed_error	Failed to join game: Unspecified error	false
random_localisation_strings_string_network_error_join_failed_game_full	Failed to join game: Game full	false
random_localisation_strings_string_network_error_join_failed_game_not_found	Failed to join game: Game not found	false
random_localisation_strings_string_network_error_join_failed_incompatible	Failed to join game: Incompatible versions	false
random_localisation_strings_string_network_error_join_failed_incompatible_avatar_product	Failed to join game: Incompatible avatar product	false
random_localisation_strings_string_network_error_join_failed_invalid_game_code	Failed to join game: Invalid game code	false
random_localisation_strings_string_network_error_join_failed_missing_save_game	Failed to join game. Failed to find required save game.	false
random_localisation_strings_string_network_error_join_failed_no_response	Failed to join game: No response from host	false
random_localisation_strings_string_network_error_join_failed_no_stats	Failed to join game: Player statistics unavailable	false
random_localisation_strings_string_network_error_join_failed_password	Failed to join game: Invalid password specified	false
random_localisation_strings_string_network_error_join_failed_rejected	Failed to join game: Rejected by host	false
random_localisation_strings_string_network_error_join_failed_system_busy	Failed to join game: System busy	false
random_localisation_strings_string_network_error_join_failed_timed_out	Failed to join game: Connection timed out	false
random_localisation_strings_string_network_error_join_result_not_allowed	Sorry, you’re currently prevented from playing the online multiplayer game.	false
random_localisation_strings_string_network_error_kicked	The host kicked you from the game.	false
random_localisation_strings_string_network_error_no_steam	text_rejected	false
random_localisation_strings_string_network_error_player_left_mode_not_allowed	Sorry, you’re currently prevented from playing with people on platforms other than Xbox Live.	false
random_localisation_strings_string_network_error_stats_no_steam	text_rejected	false
random_localisation_strings_string_network_error_steam_disconnect	You have been disconnected from Steam. Please restart Steam to continue.	false
random_localisation_strings_string_network_error_title	Error	false
random_localisation_strings_string_network_error_wrong_player	You cannot resume a game in which you were not originally involved.	false
random_localisation_strings_string_network_message_confirm_quit	Confirm quit?	false
random_localisation_strings_string_network_message_confirm_quit_host	Confirm quit? The game will end for everyone.	false
random_localisation_strings_string_network_message_content_not_owned	You were kicked from the game due to the host selecting a DLC-specific map you do not own.	false
random_localisation_strings_string_network_message_desynch	A synchronisation error has occurred; the game will now end.	false
random_localisation_strings_string_network_message_host_left	The host has left the game.	false
random_localisation_strings_string_network_message_if_not_wait_game_ends	If you choose not to wait, the game will end for everyone	false
random_localisation_strings_string_network_message_kicked_by_host	You were kicked by the host.	false
random_localisation_strings_string_network_message_no_clients_left	Client left the game	false
random_localisation_strings_string_network_message_not_responding_client	One or more players are not responding; would you like to continue waiting or leave the game?	false
random_localisation_strings_string_network_message_not_responding_host	One or more players are not responding; would you like to continue waiting or drop them?	false
random_localisation_strings_string_network_message_player_defeated	has been defeated.	false
random_localisation_strings_string_network_message_player_dropped	has been dropped from the game.	false
random_localisation_strings_string_network_message_player_dropped_end	has been dropped from the game; the game will now end.	false
random_localisation_strings_string_network_message_player_left	has left the game.	false
random_localisation_strings_string_network_message_player_left_continue_warning	\\n\\nWarning: This player will no longer be able to join any future saves made from this point onwards!	false
random_localisation_strings_string_network_message_player_left_end	has left the game; the game will now end.	false
random_localisation_strings_string_network_message_save_file_error	Failed to load multiplayer save.	false
random_localisation_strings_string_network_message_steam_connection_lost	Connection to platform was lost.	false
random_localisation_strings_string_network_message_vac_player_kicked	has been kicked from the game due to VAC authentication failure.	false
random_localisation_strings_string_network_message_vac_you_kicked	You were kicked from the game due to VAC authentication failure.	false
random_localisation_strings_string_network_message_waiting_for_response	Waiting for a response from a network player.	false
random_localisation_strings_string_network_message_you_dropped	You have lost connection to the game. 	false
random_localisation_strings_string_neutral	Neutral	false
random_localisation_strings_string_never	Never	false
random_localisation_strings_string_new_content_more_info	[[col:link]]Click here for more information about this new content.[[/col]]	false
random_localisation_strings_string_new_objective	New Objective	false
random_localisation_strings_string_night	Night	false
random_localisation_strings_string_no	No	false
random_localisation_strings_string_no_repairs_required	No repairs required	false
random_localisation_strings_string_none	Minimal	false
random_localisation_strings_string_normal	Normal	false
random_localisation_strings_string_num_breaches	Number of breaches	false
random_localisation_strings_string_num_projectiles	Number of Projectiles	false
random_localisation_strings_string_occupied_building	Occupied building	false
random_localisation_strings_string_one_minute	1 minute	false
random_localisation_strings_string_opponent_accepts_surrender_body	The defending force has complied with your demand of surrender!	false
random_localisation_strings_string_opponent_accepts_surrender_title	Surrender Accepted	false
random_localisation_strings_string_opponent_demands_surrender_body	The attacking force demands that you surrender!	false
random_localisation_strings_string_opponent_demands_surrender_title	Surrender Demanded	false
random_localisation_strings_string_opponent_refuses_surrender_body	The defending force refuses to comply with your demand of surrender!	false
random_localisation_strings_string_opponent_refuses_surrender_title	Surrender Refused	false
random_localisation_strings_string_oppressed_by	Feels oppressed by	false
random_localisation_strings_string_other	Other	false
random_localisation_strings_string_outbreak_chance	Outbreak chance	false
random_localisation_strings_string_over_x_seconds	(over %ds)	false
random_localisation_strings_string_overwrite_legendary_save_warning_text	Starting a new game on legendary will overwrite your current legendary save. Do you still want to continue?	false
random_localisation_strings_string_overwrite_legendary_save_warning_title	Overwrite existing legendary save?	false
random_localisation_strings_string_overwrite_msg	You are attempting to save over an existing file, overwrite it?	false
random_localisation_strings_string_overwrite_title	Overwrite File?	false
random_localisation_strings_string_owner_colon	Owner:	false
random_localisation_strings_string_passive_on_cooldown_remaining	Recharges in %d seconds	false
random_localisation_strings_string_patch_notes_more_info	[[col:link]]Click here for more information about this patch.[[/col]]	false
random_localisation_strings_string_per_entity	Per Entity	false
random_localisation_strings_string_per_second	Per Second	false
random_localisation_strings_string_phase	Phase	false
random_localisation_strings_string_phase_destroy_ammunition	Destroys Ammunition	false
random_localisation_strings_string_phase_replenish_ammunition	Replenishes Ammunition	false
random_localisation_strings_string_ping_added_by	Ping added by: 	false
random_localisation_strings_string_ping_attack	Attack here!	false
random_localisation_strings_string_ping_defend	Defend here!	false
random_localisation_strings_string_ping_move	Move here!	false
random_localisation_strings_string_ping_none	No ping	false
random_localisation_strings_string_ping_notification	Attention!	false
random_localisation_strings_string_ping_standard	Look here!	false
random_localisation_strings_string_play_battle	Play Battle	false
random_localisation_strings_string_player_disconnected	has disconnected.	false
random_localisation_strings_string_player_is_mp_co_op_ally_and_cannot_attack	Cannot attack your multiplayer cooperative ally.	false
random_localisation_strings_string_player_is_vassal_and_cannot_attack	text_rejected	false
random_localisation_strings_string_player_stat_battles_finished	Battles finished	false
random_localisation_strings_string_player_stat_battles_lost	Battles lost	false
random_localisation_strings_string_player_stat_battles_started	Battles started	false
random_localisation_strings_string_player_stat_battles_won	Battles won	false
random_localisation_strings_string_player_stat_men_killed	Total troops killed or captured	false
random_localisation_strings_string_player_stats_best_1v1_placement	Best ladder placement 1v1 land	false
random_localisation_strings_string_player_stats_best_1v1_skill	Best all time skill rating 1v1 land	false
random_localisation_strings_string_player_stats_best_2v2_placement	Best ladder placement 2v2 land	false
random_localisation_strings_string_player_stats_best_2v2_skill	Best all time skill rating 2v2 land	false
random_localisation_strings_string_player_stats_best_3v3_placement	Best ladder placement 3v3 land	false
random_localisation_strings_string_player_stats_best_3v3_skill	Best all time skill rating 3v3 land	false
random_localisation_strings_string_player_stats_best_4v4_placement	Best ladder placement 4v4 land	false
random_localisation_strings_string_player_stats_best_4v4_skill	Best all time skill rating 4v4 land	false
random_localisation_strings_string_player_stats_best_clan_ladder_placement	text_rejected	false
random_localisation_strings_string_player_stats_best_streak	Best streak	false
random_localisation_strings_string_player_stats_campaign_battles_fought_personally	Campaign battles fought personally	false
random_localisation_strings_string_player_stats_campaign_land_battles_lost	Campaign land battles lost	false
random_localisation_strings_string_player_stats_campaign_land_battles_won	Campaign land battles won	false
random_localisation_strings_string_player_stats_campaign_naval_battles_lost	Campaign naval battles lost	false
random_localisation_strings_string_player_stats_campaign_naval_battles_won	Campaign naval battles won	false
random_localisation_strings_string_player_stats_campaigns_completed	Campaigns completed	false
random_localisation_strings_string_player_stats_decisive_victories	Number of decisive victories	false
random_localisation_strings_string_player_stats_enemy_generals_killed	Enemy Lords killed	false
random_localisation_strings_string_player_stats_enemy_ships_sunk	Enemy ships sunk	false
random_localisation_strings_string_player_stats_enemy_units_wiped_out	Most enemy units wiped out	false
random_localisation_strings_string_player_stats_friendly_units_rallied	Most friendly units rallied	false
random_localisation_strings_string_player_stats_generals_lost	Lords lost	false
random_localisation_strings_string_player_stats_men_lost	Troops lost	false
random_localisation_strings_string_player_stats_most_men_killed	Most troops killed in a battle	false
random_localisation_strings_string_player_stats_most_men_lost	Most troops lost in a battle	false
random_localisation_strings_string_player_stats_mp_consecutive_land	Number of consecutive land battles won	false
random_localisation_strings_string_player_stats_mp_consecutive_naval	Number of consecutive naval battles won	false
random_localisation_strings_string_player_stats_ranked_land_battles_lost	Ranked land battles lost	false
random_localisation_strings_string_player_stats_ranked_land_battles_won	Ranked land battles won	false
random_localisation_strings_string_player_stats_ranked_naval_battles_lost	Ranked naval battles lost	false
random_localisation_strings_string_player_stats_ranked_naval_battles_won	Ranked naval battles won	false
random_localisation_strings_string_player_stats_ships_lost	Ships lost	false
random_localisation_strings_string_player_stats_total_men_dead	Troops killed in battle (friend or foe)	false
random_localisation_strings_string_player_stats_total_mp_land_battles_completed	Total multiplayer land battles completed	false
random_localisation_strings_string_player_stats_total_mp_land_battles_won	Total multiplayer land battles won	false
random_localisation_strings_string_player_stats_total_mp_naval_battles_completed	Total multiplayer naval battles completed	false
random_localisation_strings_string_player_stats_total_mp_naval_battles_won	Total multiplayer naval battles won	false
random_localisation_strings_string_player_withdraw_units_redistributed	This player has withdrawn. Their units have been shared amongst the remaining players in the team.	false
random_localisation_strings_string_player_withdrawn	This player has withdrawn, the AI will take control of their army.	false
random_localisation_strings_string_points_for_next_ability	Points needed for next ability: %d/%d	false
random_localisation_strings_string_pooled_cost	%s cost:	false
random_localisation_strings_string_port	Port	false
random_localisation_strings_string_power_category_1	Terrifying	false
random_localisation_strings_string_power_category_2	Mighty	false
random_localisation_strings_string_power_category_3	Strong	false
random_localisation_strings_string_power_category_4	Moderate	false
random_localisation_strings_string_power_category_5	Weak	false
random_localisation_strings_string_power_category_6	Feeble	false
random_localisation_strings_string_power_ranking	Strength Rank	false
random_localisation_strings_string_power_ranking_tooltip	This is their faction's strength ranking, rated against all existing factions.	false
random_localisation_strings_string_power_ranking_tooltip_player	This is your faction's strength ranking, rated against all existing factions.	false
random_localisation_strings_string_pre-battle_multiplayer_auto_resolve	Auto-resolve	false
random_localisation_strings_string_pre-battle_multiplayer_dismiss	Dismiss	false
random_localisation_strings_string_pre-battle_multiplayer_maintain_siege	Maintain Siege	false
random_localisation_strings_string_pre-battle_multiplayer_play_as_ai	Play as AI	false
random_localisation_strings_string_pre-battle_multiplayer_play_battle	Play Battle	false
random_localisation_strings_string_pre-battle_multiplayer_retreat	Retreat	false
random_localisation_strings_string_pre-battle_multiplayer_spectate	Spectate	false
random_localisation_strings_string_pre-battle_multiplayer_support_attacker	Support Attacker	false
random_localisation_strings_string_pre-battle_multiplayer_support_defender	Support Defender	false
random_localisation_strings_string_pre-battle_multiplayer_undecided	Undecided	false
random_localisation_strings_string_pre_battle_siege_equipment_totals_tooltip	Constructing siege items: %d\\nConstructed siege items: %d	false
random_localisation_strings_string_pre_battle_siege_equipment_totals_tooltip_cap	\\nCap: %d	false
random_localisation_strings_string_prebattle_banners	{{tr:prebattle_banners}}	false
random_localisation_strings_string_prebattle_description_tunnel_intercept	{{tr:prebattle_description_tunnel_intercept}}	false
random_localisation_strings_string_prebattle_description_tunnel_intercepted	{{tr:prebattle_description_tunnel_intercepted}}	false
random_localisation_strings_string_prebattle_garrison_army	Settlement garrison	false
random_localisation_strings_string_prebattle_legendary_cannot_save	You cannot save before a battle when playing Ironman mode	false
random_localisation_strings_string_prebattle_popup_defection_01	Defection!	false
random_localisation_strings_string_prebattle_popup_defection_02	Some of your armies have defected and will now oppose you on the battlefield!	false
random_localisation_strings_string_prebattle_popup_defection_03	Some of the enemy's armies have defected and will now join you on the battlefield!	false
random_localisation_strings_string_prebattle_popup_defection_04	Some of the enemy's armies have defected and will join you on the battlefield, however some of yours have also defected and will now oppose you!	false
random_localisation_strings_string_prebattle_reinforcing_army	reinforcements	false
random_localisation_strings_string_prebattle_title_ambush	{{tr:prebattle_title_ambush}}	false
random_localisation_strings_string_prebattle_title_default	{{tr:prebattle_title_default}}	false
random_localisation_strings_string_prebattle_title_discovered	Discovered!	false
random_localisation_strings_string_prebattle_title_intercept	{{tr:prebattle_title_intercept}}	false
random_localisation_strings_string_prebattle_title_intercepted	{{tr:prebattle_title_intercepted}}	false
random_localisation_strings_string_prebattle_title_settlement_intercepted	Intercepted by Settlement!	false
random_localisation_strings_string_prebattle_title_tunnel_intercept	{{tr:prebattle_title_tunnel_intercept}}	false
random_localisation_strings_string_prebattle_title_tunnel_intercepted	{{tr:prebattle_title_tunnel_intercepted}}	false
random_localisation_strings_string_prebattle_underground_terrain_type	{{tr:prebattle_underground_terrain_type}}	false
random_localisation_strings_string_predicted_income	Predicted income	false
random_localisation_strings_string_predicted_income_explanation	This is the amount of {{tr:icon_income}}income you are expected to receive in the next turn.	false
random_localisation_strings_string_prestige_category_1	Sublime	false
random_localisation_strings_string_prestige_category_2	Majestic	false
random_localisation_strings_string_prestige_category_3	Respected	false
random_localisation_strings_string_prestige_category_4	Moderate	false
random_localisation_strings_string_prestige_category_5	Weak	false
random_localisation_strings_string_prestige_category_6	Feeble	false
random_localisation_strings_string_producing	Producing	false
random_localisation_strings_string_projectile_range	Projectile Range	false
random_localisation_strings_string_province_colon	Province:	false
random_localisation_strings_string_public_order	Current {{tr:public_order}}	false
random_localisation_strings_string_purchase_dialog_txt	Extra downloadable content is required to join this game.	false
random_localisation_strings_string_queued_building_blocked_by_stance	{{tr:queued_building_blocked_by_stance}}	false
random_localisation_strings_string_quick_save	Quick Save	false
random_localisation_strings_string_quit_battle	You are about to quit this battle. Are you sure?	false
random_localisation_strings_string_quit_battle_button_text_quit_battle	Quit Battle	false
random_localisation_strings_string_quit_battle_button_text_quit_replay	Quit Replay	false
random_localisation_strings_string_quit_battle_button_text_skip	Skip Battle	false
random_localisation_strings_string_quit_battle_cant_withdraw_warning	[[col:dark_r]]As you cannot withdraw from this battle, conceding defeat will lose the entirety of this force![[/col]]	false
random_localisation_strings_string_quit_frontend	This will exit to the main menu. Are you sure?	false
random_localisation_strings_string_quit_game_main	You are about to quit the game. Are you sure?	false
random_localisation_strings_string_quit_warning	If you quit now you will lose all unsaved progress	false
random_localisation_strings_string_quit_warning_mpc	If you quit now, the game will continue in your absence and you will no longer be able to join any future saves made from this point onwards!	false
random_localisation_strings_string_raided	Raided	false
random_localisation_strings_string_random	Random	false
random_localisation_strings_string_range	Effect Range	false
random_localisation_strings_string_ranged_damage	Ranged Damage	false
random_localisation_strings_string_reason	Reason:	false
random_localisation_strings_string_rebel_faction_name_override	{{tr:rebel_faction_name_override}}	false
random_localisation_strings_string_recharge_blocked	[[col:red]]Recharge blocked[[/col]]	false
random_localisation_strings_string_recharge_change	[[img:ui/skins/default/icon_cooldown.png]][[/img]]Ability Recharge (seconds)	false
random_localisation_strings_string_recharge_context_blocked	\\n\\n[[col:red]]Recharge blocked[[/col]]	false
random_localisation_strings_string_recharge_context_improved	\\n\\n[[col:green]]Recharge improved[[/col]]	false
random_localisation_strings_string_recharge_depleted	[[col:red]]Charge depleted[[/col]]	false
random_localisation_strings_string_recharge_rate	Recharge: 1 power per %S seconds	false
random_localisation_strings_string_recharge_while	Recharges while %s	false
random_localisation_strings_string_recruitment_cost	Recruitment Cost	false
random_localisation_strings_string_recruitment_from	This unit can be recruited from:	false
random_localisation_strings_string_recruitment_travel_time	Once recruited, joining this army will take additional turns:	false
random_localisation_strings_string_recruitment_unavailable	This unit is unavailable for the following reasons:	false
random_localisation_strings_string_recycle_tooltip	Recycling these units will award %d [[img:icon_growth_juice]][[/img]]Growth Juice	false
random_localisation_strings_string_recycle_units_title	Recycling	false
random_localisation_strings_string_recycle_units_warning	Are you sure you wish to recycle the selection?	false
random_localisation_strings_string_reduced_unit_limit_msg	The host has reduced the maximum unit setting causing some to be removed from your setup.	false
random_localisation_strings_string_reduced_unit_limit_msg_sp	You have reduced the maximum unit setting, causing some to be removed from your setup.	false
random_localisation_strings_string_region_capital	Settlement	false
random_localisation_strings_string_region_colon	Region:	false
random_localisation_strings_string_reinforcement_arrows	Any arrows indicate forces that can reinforce this army in battle.	false
random_localisation_strings_string_reinforcement_fund_multiplier	Default funds for battles involving reinforcements are scaled based on the number of players in a team	false
random_localisation_strings_string_reinforcements	Reinforcements	false
random_localisation_strings_string_relative_mana_tooltip	The balance of total available Magic for each alliance.	false
random_localisation_strings_string_reliability	Trustworthiness	false
random_localisation_strings_string_repair_cost	Repair\\n\\nIf you do not repair this building, it will slowly repair itself over time.\\n\\nCost to repair: {{tr:icon_treasury}} %d	false
random_localisation_strings_string_repair_cost_pooled_resource	Repair\\n\\nIf you do not repair this building, it will slowly repair itself over time.\\n\\nCost to repair: [[img:%s]][[/img]] %d	false
random_localisation_strings_string_replenishment_cap	This unit can replenish %d %s (up to [[col:red]]%d[[/col]])	false
random_localisation_strings_string_requires_ally_target	Requires Ally Target	false
random_localisation_strings_string_requires_enemy_target	Requires Enemy Target	false
random_localisation_strings_string_requires_ground_target	Requires Ground Target	false
random_localisation_strings_string_requires_self_target	Requires Self Target	false
random_localisation_strings_string_requires_target	Requires target	false
random_localisation_strings_string_resistance_fire_tooltip	Fire Resistance: %d%%||Damage of [[img:ui/skins/default/modifier_icon_flaming.png]][[/img]]flaming attacks is reduced by this amount.	false
random_localisation_strings_string_resistance_magic_tooltip	Spell Resistance: %d%%||Damage of [[img:ui/skins/default/modifier_icon_magical.png]][[/img]]spells and magical abilities is reduced by this amount.	false
random_localisation_strings_string_resistance_missile_tooltip	Missile Resistance: %d%%||Damage of missile attacks is reduced by this amount.	false
random_localisation_strings_string_resistance_physical_tooltip	Physical Resistance: %d%%||Damage of non-magical attacks is reduced by this amount.	false
random_localisation_strings_string_resistance_ward_save_tooltip	Ward Save: %d%%||Any type of damage is reduced by this amount.	false
random_localisation_strings_string_resource	Resource	false
random_localisation_strings_string_resource_exporting_percentage	Exporting:	false
random_localisation_strings_string_resource_exporting_percentage_not_full	Increasing trade routes will increase the percentage of this resource you can export.	false
random_localisation_strings_string_resource_exporting_percentage_zero	A trade route is required to export this resource.	false
random_localisation_strings_string_resource_importing_from	Importing from:	false
random_localisation_strings_string_resource_long_term	Long term partnership: {{tr:icon_income}}%n||As this trade agreement is long-standing, a bonus to the trade income is being supplied. This will slowly increase over time.	false
random_localisation_strings_string_resource_not_acquired	[[col:red]]This resource has not yet been acquired.[[/col]]	false
random_localisation_strings_string_resource_tariffs	Tariffs: {{tr:icon_income}} %n||Tariffs are taxes imposed on foreign merchants that visit your realm to trade. These are not affected by tradable resources and provide a base income from every trade agreement you have.	false
random_localisation_strings_string_resource_value	Resource value: {{tr:icon_money}}	false
random_localisation_strings_string_restart_demo	Restart demo	false
random_localisation_strings_string_resync_filename	resync	false
random_localisation_strings_string_retreat	Retreat	false
random_localisation_strings_string_reveal	Reveal	false
random_localisation_strings_string_right_click_building_browser	Right-click to view in Building Browser	false
random_localisation_strings_string_right_click_info	Right-click for further information.	false
random_localisation_strings_string_right_click_pin	\\nRight-click to pin info panel	false
random_localisation_strings_string_right_click_spell_browser	Right-click to view in the [[img:ui/skins/default/icon_spell_browser_02.png]][[/img]]Unit & Spell Browser.	false
random_localisation_strings_string_ritual_completed	Ritual Completed	false
random_localisation_strings_string_road	Road	false
random_localisation_strings_string_round_id_april	April	false
random_localisation_strings_string_round_id_august	August	false
random_localisation_strings_string_round_id_december	December	false
random_localisation_strings_string_round_id_early_april	Early April	false
random_localisation_strings_string_round_id_early_august	Early August	false
random_localisation_strings_string_round_id_early_december	Early December	false
random_localisation_strings_string_round_id_early_february	Early February	false
random_localisation_strings_string_round_id_early_january	Early January	false
random_localisation_strings_string_round_id_early_july	Early July	false
random_localisation_strings_string_round_id_early_june	Early June	false
random_localisation_strings_string_round_id_early_march	Early March	false
random_localisation_strings_string_round_id_early_may	Early May	false
random_localisation_strings_string_round_id_early_november	Early November	false
random_localisation_strings_string_round_id_early_october	Early October	false
random_localisation_strings_string_round_id_early_september	Early September	false
random_localisation_strings_string_round_id_february	February	false
random_localisation_strings_string_round_id_january	January	false
random_localisation_strings_string_round_id_july	July	false
random_localisation_strings_string_round_id_june	June	false
random_localisation_strings_string_round_id_late_april	Late April	false
random_localisation_strings_string_round_id_late_august	Late August	false
random_localisation_strings_string_round_id_late_december	Late December	false
random_localisation_strings_string_round_id_late_february	Late February	false
random_localisation_strings_string_round_id_late_january	Late January	false
random_localisation_strings_string_round_id_late_july	Late July	false
random_localisation_strings_string_round_id_late_june	Late June	false
random_localisation_strings_string_round_id_late_march	Late March	false
random_localisation_strings_string_round_id_late_may	Late May	false
random_localisation_strings_string_round_id_late_november	Late November	false
random_localisation_strings_string_round_id_late_october	Late October	false
random_localisation_strings_string_round_id_late_september	Late September	false
random_localisation_strings_string_round_id_march	March	false
random_localisation_strings_string_round_id_may	May	false
random_localisation_strings_string_round_id_november	November	false
random_localisation_strings_string_round_id_october	October	false
random_localisation_strings_string_round_id_september	September	false
random_localisation_strings_string_ruined	Ruined	false
random_localisation_strings_string_sanitation	Sanitation	false
random_localisation_strings_string_save_fail	Save Failed	false
random_localisation_strings_string_save_lab_settings	Save Settings	false
random_localisation_strings_string_save_old_version_loading_warning	[[col:yellow]]This save file was made on an older version of the game. It will function, but you may experience odd or unexpected behaviour due to recent updates to the game.[[/col]]	false
random_localisation_strings_string_save_preset	Save Preset	false
random_localisation_strings_string_save_success	Save succeeded	false
random_localisation_strings_string_scripted_tour_invalid_insufficient_enemy_units	Insufficient suitable enemy units to take this tour.	false
random_localisation_strings_string_scripted_tour_invalid_insufficient_player_units	Insufficient suitable player units to take this tour.	false
random_localisation_strings_string_scripted_tour_invalid_is_ambush_battle	Tour cannot be taken in an ambush battle.	false
random_localisation_strings_string_scripted_tour_invalid_is_not_normal_land_battle	Tour can only be taken in a standard land battle.	false
random_localisation_strings_string_scripted_tour_invalid_not_battle	Tour can only be taken in battle.	false
random_localisation_strings_string_scripted_tour_invalid_not_conflict_phase	Tour cannot be taken if main battle phase is not underway.	false
random_localisation_strings_string_scripted_tour_invalid_not_deployment_or_conflict_phase	Tour cannot be taken if battle is not in deployment or main combat phase.	false
random_localisation_strings_string_scripted_tour_invalid_not_major_siege_battle	Tour can only be taken in a major siege battle.	false
random_localisation_strings_string_scripted_tour_invalid_not_minor_settlement_battle	Tour can only be taken in a minor settlement battle.	false
random_localisation_strings_string_scripted_tour_invalid_not_normal_land_battle	Tour can only be taken in a standard land battle.	false
random_localisation_strings_string_scripted_tour_invalid_not_singleplayer	Tour cannot be taken in multiplayer mode.	false
random_localisation_strings_string_scripted_tour_invalid_player_not_attacker	Tour can only be taken if the player is attacking.	false
random_localisation_strings_string_scripted_tour_invalid_player_not_defender	Tour can only be taken if the player is defending.	false
random_localisation_strings_string_scripted_tour_invalid_player_not_deployment	Tour can only be taken during deployment.	false
random_localisation_strings_string_scripted_tour_invalid_suitable_area_not_found	Suitable combat area not found.	false
random_localisation_strings_string_sea_region_control_status_contested	[[col:red]](Contested)[[/col]]	false
random_localisation_strings_string_sea_region_control_status_controlled	(Controlled)	false
random_localisation_strings_string_sea_region_control_status_hostile	[[col:red]](Hostile)[[/col]]	false
random_localisation_strings_string_sea_region_control_status_neutral	(Neutral)	false
random_localisation_strings_string_sea_region_control_status_shared	(Shared)	false
random_localisation_strings_string_seamen	text_rejected	false
random_localisation_strings_string_seconds	seconds	false
random_localisation_strings_string_seconds_abbreviated	s	false
random_localisation_strings_string_self	Self	false
random_localisation_strings_string_settlement_colon	Settlement:	false
random_localisation_strings_string_settlement_spy_info_no_info	No spy information available	false
random_localisation_strings_string_settlement_strength	Settlement Strength	false
random_localisation_strings_string_ship_card_crew_lost_ship_scuppered	text_rejected	false
random_localisation_strings_string_ship_card_red_captured	This ship was captured by the enemy!	false
random_localisation_strings_string_ship_card_red_destroyed	This ship was destroyed in battle.	false
random_localisation_strings_string_ship_card_red_general_killed	The general of this ship was killed in battle.	false
random_localisation_strings_string_shortcut	Shortcut	false
random_localisation_strings_string_shot_duration	[[img:ui/skins/default/icon_stat_reload_time.png]][[/img]] Reload Time	false
random_localisation_strings_string_shots_per_volley	Shots per volley	false
random_localisation_strings_string_siege_suffering_attrition	This settlement's garrison has run out of supplies and is suffering [[img:icon_attrition]][[/img]]attrition.	false
random_localisation_strings_string_siege_turns_to_attrition	Turns remaining before garrison will run out of supplies:	false
random_localisation_strings_string_siege_turns_to_surrender	\\nTurns remaining before surrender:	false
random_localisation_strings_string_siege_vehicle_tooltip	The number of siege vehicles available is based on the number of infantry units you have. \\n Overall:	false
random_localisation_strings_string_signed_effect_percent	%+d%	false
random_localisation_strings_string_skill_current_level	Current level:	false
random_localisation_strings_string_skill_locked_auto_unlock	\\n\\n[[col:red]]Automatically granted at rank %d.[[/col]]	false
random_localisation_strings_string_skill_locked_multi_parent	\\n\\n[[col:red]]Available after spending %d skill points in the previous group.[[/col]]	false
random_localisation_strings_string_skill_locked_rank	\\n\\n[[col:red]]Available at rank %d.[[/col]]	false
random_localisation_strings_string_skill_locked_rank_quest	\\n\\n[[col:red]]This quest will automatically begin at rank %d.[[/col]]	false
random_localisation_strings_string_skill_locked_single_parent	\\n\\n[[col:red]]Available after unlocking "%S".[[/col]]	false
random_localisation_strings_string_skill_locked_single_parent_multiple_points	\\n\\n[[col:red]]Available after spending %d skill points on the previous skill.[[/col]]	false
random_localisation_strings_string_skill_next_level	Next level:	false
random_localisation_strings_string_skills_num_points	points in	false
random_localisation_strings_string_skills_requires	Requires	false
random_localisation_strings_string_skip_battle	Skip Battle	false
random_localisation_strings_string_slaves_percent	Immigrant percent	false
random_localisation_strings_string_small	Small	false
random_localisation_strings_string_small_entity	{{tr:uied_component_texts_localised_string_dy_men_small_Tooltip_180019a}}	false
random_localisation_strings_string_small_entity_campaign	{{tr:uied_component_texts_localised_string_dy_men_small_Tooltip_180019a}}	false
random_localisation_strings_string_special_ability_max_target	(max: %d)	false
random_localisation_strings_string_special_ability_tooltip_all	all	false
random_localisation_strings_string_spectator_list_tooltip	Spectators	false
random_localisation_strings_string_spell_details	Spell details	false
random_localisation_strings_string_spell_mastery_tooltip	Spell Mastery: %d%%||How adept this unit is at casting spells	false
random_localisation_strings_string_spread_over_x	Spread over %d Entities	false
random_localisation_strings_string_stance_food_consumption	Food consumption from region: %n	false
random_localisation_strings_string_stance_food_stolen	Food stolen from region: %n	false
random_localisation_strings_string_start_battle	Start Battle	false
random_localisation_strings_string_stat_ap_damage	[[img:ui/skins/default/modifier_icon_armour_piercing.png]][[/img]]Armour-piercing damage	false
random_localisation_strings_string_stat_base_damage	Base damage	false
random_localisation_strings_string_stat_base_reload_time	Base reload time	false
random_localisation_strings_string_stat_base_value	Base value	false
random_localisation_strings_string_stat_bonus_cavalry	Bonus vs. Cavalry	false
random_localisation_strings_string_stat_bonus_elephant	[[img:ui/skins/default/modifier_icon_bonus_vs_large.png]][[/img]]Bonus vs. Large	false
random_localisation_strings_string_stat_bonus_infantry	[[img:ui/skins/default/modifier_icon_bonus_vs_infantry.png]][[/img]]Bonus vs. Infantry	false
random_localisation_strings_string_stat_can_target_buildings	(can damage buildings)	false
random_localisation_strings_string_stat_explosion_damage	[[img:ui/skins/default/icon_explosive_damage.png]][[/img]] Base Explosive Damage	false
random_localisation_strings_string_stat_explosion_damage_ap	[[img:ui/skins/default/icon_stat_explosive_armour_piercing_damage.png]][[/img]] Armour-piercing Explosive Damage	false
random_localisation_strings_string_stat_men_hp	Troop HP	false
random_localisation_strings_string_stat_mount_hp	Mount HP	false
random_localisation_strings_string_stat_reload_time	Reload Time	false
random_localisation_strings_string_stat_shield	Shield value	false
random_localisation_strings_string_stat_total_missile_damage	Total Missile Damage	false
random_localisation_strings_string_stat_xp_value	XP bonus	false
random_localisation_strings_string_state_religion_change_active	Can change religion	false
random_localisation_strings_string_state_religion_change_inactive_faction_leader_already_changed	Already changed religion	false
random_localisation_strings_string_state_religion_change_inactive_not_enough_support	Cannot change religion, not enough support	false
random_localisation_strings_string_target	Target	false
random_localisation_strings_string_tax_level_0	Minimal	false
random_localisation_strings_string_tax_level_1	Low	false
random_localisation_strings_string_tax_level_2	Normal	false
random_localisation_strings_string_tax_level_3	High	false
random_localisation_strings_string_tax_level_4	Extortionate	false
random_localisation_strings_string_tech_required_for_construction	text_rejected	false
random_localisation_strings_string_technology_1_required	Requires 1 technology	false
random_localisation_strings_string_technology_bonuses_tooltip	Research rate:	false
random_localisation_strings_string_technology_disabled_by	Disabled by	false
random_localisation_strings_string_technology_disabled_by_buildings	Required buildings	false
random_localisation_strings_string_technology_disabled_by_technologies	Requires additional technologies	false
random_localisation_strings_string_technology_required	Requires technology	false
random_localisation_strings_string_technology_x_required	Requires %d technologies	false
random_localisation_strings_string_test	test	false
random_localisation_strings_string_the_selected_item_may_not_be_dismantled	[[col:red]]The selected item may not be demolished.[[/col]]	false
random_localisation_strings_string_tile_upgrade_encampment	Encampment	false
random_localisation_strings_string_tile_upgrade_none	None	false
random_localisation_strings_string_tile_upgrade_settlement_escalation1	Escalation level 1	false
random_localisation_strings_string_tile_upgrade_settlement_escalation2	Escalation level 2	false
random_localisation_strings_string_tile_upgrade_settlement_level1	Level 01	false
random_localisation_strings_string_tile_upgrade_settlement_level2	Level 02	false
random_localisation_strings_string_tile_upgrade_settlement_level3	Level 03	false
random_localisation_strings_string_tile_upgrade_settlement_level4	Level 04	false
random_localisation_strings_string_tile_upgrade_settlement_no_escalation	No escalation	false
random_localisation_strings_string_time_days	days	false
random_localisation_strings_string_time_hours	hours	false
random_localisation_strings_string_tooltip_army_loader_over_budget	This setup is too expensive.	false
random_localisation_strings_string_tooltip_army_loader_unit_group_cap	This setup contains too many units of a particular type.	false
random_localisation_strings_string_tooltip_content_alert	Additional Content Available	false
random_localisation_strings_string_tooltip_disband_lord	Replace Lord	false
random_localisation_strings_string_tooltip_disband_unit	{{tr:disband_tooltip}}	false
random_localisation_strings_string_tooltip_dlc	Expand your Total War: WARHAMMER II experience with: %S\\n\\nLeft-click to go to the Steam store page.	false
random_localisation_strings_string_tooltip_free_content_alert	Free content available!	false
random_localisation_strings_string_tooltip_healing_power	Incoming Healing Modifier||[[img:icon_healing_power]][[/img]] Incoming Healing Modifier alters the effectiveness of all healing received from spells and abilities.\\n\\n[[img:bullet_point]][[/img]]100% is the default healing rate.\\n[[img:bullet_point]][[/img]]Modifying this stat affects the default healing rate.\\nFor example: [[i]]200% doubles the effectiveness of healing received.[[/i]]\\n[[img:bullet_point]][[/img]][[img:icon_dmg_flaming]][[/img]]Flaming Attacks halve the Incoming Healing Modifier of affected units.	false
random_localisation_strings_string_tooltip_horde_invalid_for_recruitment	[[col:red]]You cannot replace a Lord with another Lord if either of them has horde buildings.[[/col]]	false
random_localisation_strings_string_tooltip_kills	Kills: %d\\nDamage dealt: %d\\nDamage dealt as gold value: %d||The number of kills this unit has made in this battle. Kills will count toward a unit's XP.	false
random_localisation_strings_string_tooltip_raise_black_ark_convalescence_cause_retirement	[[col:red]]This Black Ark was recently disbanded. It will be available for recruitment in %d turns.[[/col]]	false
random_localisation_strings_string_tooltip_raise_black_ark_once_per_turn_per_province_limit_reached	[[col:red]]You have already recruited a Black Ark in this province this turn. Only one Black Ark may be recruited in a province each turn.[[/col]]	false
random_localisation_strings_string_tooltip_raise_character_invalid_agent_subtype_for_recruitment_type	[[col:red]]This character cannot be recruited here. They must be recruited from a valid location.[[/col]]	false
random_localisation_strings_string_tooltip_raise_hero_convalescence_cause_imprisoned	[[col:red]]This [[img:icon_hero]][[/img]]Hero has been imprisoned.[[/col]]	false
random_localisation_strings_string_tooltip_raise_hero_insufficient_influence	[[col:red]]Cannot recruit [[img:icon_hero]][[/img]]Hero\\n\\nYou have insufficient [[img:icon_influence]][[/img]]influence.[[/col]]	false
random_localisation_strings_string_tooltip_raise_lord_convalescence_cause_assasination	[[col:red]]This character was recently wounded in an assassination attempt. They will be available for recruitment in %d turns.[[/col]]	false
random_localisation_strings_string_tooltip_raise_lord_convalescence_cause_battle	[[col:red]]This character was recently wounded in battle. They will be available for recruitment in %d turns.[[/col]]	false
random_localisation_strings_string_tooltip_raise_lord_convalescence_cause_conversion	PLACEHOLDER	false
random_localisation_strings_string_tooltip_raise_lord_convalescence_cause_hunted_down	PLACEHOLDER	false
random_localisation_strings_string_tooltip_raise_lord_convalescence_cause_imprisoned	[[col:red]]This [[img:icon_general]][[/img]]Lord has been imprisoned.[[/col]]	false
random_localisation_strings_string_tooltip_raise_lord_convalescence_cause_retirement	[[col:red]]This [[img:icon_general]][[/img]]Lord was recently replaced. They will be available for recruitment in %d turns.[[/col]]	false
random_localisation_strings_string_tooltip_raise_lord_insufficient_influence	[[col:red]]Cannot recruit [[img:icon_general]][[/img]]Lord\\n\\nYou have insufficient [[img:icon_influence]][[/img]]influence.[[/col]]	false
random_localisation_strings_string_tooltip_raise_lord_once_per_turn_per_province_limit_reached	{{tr:tooltip_raise_lord_once_per_turn_per_province_limit_reached}}	false
random_localisation_strings_string_tooltip_raise_lord_performing_ritual	[[col:red]]This character is currently recovering and is convalescing. They will be available for recruitment in %d turns.[[/col]]	false
random_localisation_strings_string_tooltip_raise_lord_unavailable	[[col:red]]This Legendary Lord will be available for recruitment at a later time.[[/col]]	false
random_localisation_strings_string_tooltip_raise_lord_wounded	[[col:red]]This character is currently wounded and is convalescing. They will be available for recruitment in %d turns.[[/col]]	false
random_localisation_strings_string_tooltip_replenishment_cap	Every unit has limited hit point regeneration in battle	false
random_localisation_strings_string_tooltip_vehicle_health	Vehicle health	false
random_localisation_strings_string_total_funds_available	Total funds available: [[img:ui/skins/default/icon_income.png]][[/img]]%d	false
random_localisation_strings_string_total_funds_available_for	Total funds available for %s: [[img:ui/skins/default/icon_income.png]][[/img]]%d	false
random_localisation_strings_string_total_numeric	Total	false
random_localisation_strings_string_total_value	Income: {{tr:icon_income}}	false
random_localisation_strings_string_town	Town	false
random_localisation_strings_string_trade_agreement_tooltip_embargoed	Embargo prevents trade agreement	false
random_localisation_strings_string_trade_agreement_tooltip_existing_route_shifted	One of your current sea trade routes is eligible for diversion over land.||Another sea route from your capital may be established.	false
random_localisation_strings_string_trade_agreement_tooltip_export_route_count	Sea export routes remaining – You: %d/%d, Them: %d/%d ||This is based on trade ports in the capital's province.	false
random_localisation_strings_string_trade_agreement_tooltip_neighbour	An overland trade route will link your two capitals.	false
random_localisation_strings_string_trade_agreement_tooltip_no_borders	[[col:red]]The ports in your home province are at full capacity.||A sea route from your capital cannot be established.[[/col]]	false
random_localisation_strings_string_trade_agreement_tooltip_no_route_them	[[col:red]]A route from their capital cannot be established.[[/col]]	false
random_localisation_strings_string_trade_agreement_tooltip_no_route_you	[[col:red]]The ports in your home province are at full capacity.||A sea route from your capital cannot be established.[[/col]]	false
random_localisation_strings_string_trade_agreement_tooltip_no_sea_routes	[[col:red]]The ports in their capital are at full capacity.||A sea route from their capital cannot be established.[[/col]]	false
random_localisation_strings_string_trade_agreement_tooltip_sea_routes	A sea trade route will link your two capitals.	false
random_localisation_strings_string_trade_lost	Not exported. Upgrade your ports to earn more money by exporting these commodities.	false
random_localisation_strings_string_trade_node_tooltip_base_supply	supplies to be gained from first trade ship	false
random_localisation_strings_string_trade_node_tooltip_predicted_supply	estimated supplies to be gained	false
random_localisation_strings_string_trade_node_tooltip_supply_to_other	supplied to their capital	false
random_localisation_strings_string_trade_node_tooltip_supply_to_you	supplied to your capital	false
random_localisation_strings_string_trade_post	Trade post	false
random_localisation_strings_string_trade_route	Trade route	false
random_localisation_strings_string_trade_route_state_enemy	(Enemy)	false
random_localisation_strings_string_trade_route_state_neutral	(Neutral)	false
random_localisation_strings_string_trade_route_state_player	(Yours)	false
random_localisation_strings_string_trade_route_state_shared	(Shared)	false
random_localisation_strings_string_trade_route_tooltip_enemy	(enemy)	false
random_localisation_strings_string_trade_route_tooltip_local_enemy	(yours shared with enemy)	false
random_localisation_strings_string_trade_route_tooltip_local_neutral	(yours shared with others)	false
random_localisation_strings_string_trade_route_tooltip_neutral	(others)	false
random_localisation_strings_string_trade_route_tooltip_other_factions	Others	false
random_localisation_strings_string_trade_route_tooltip_raid_value	Trade route raid value:	false
random_localisation_strings_string_trade_status_tooltip_already_trading	Already trading	false
random_localisation_strings_string_trade_status_tooltip_can	Can trade	false
random_localisation_strings_string_trade_status_tooltip_cannot	[[col:red]]Cannot trade[[/col]]	false
random_localisation_strings_string_trade_status_tooltip_cannot_at_war	[[col:red]]Cannot trade\\nYou are at war with this faction.[[/col]]	false
random_localisation_strings_string_trade_status_tooltip_cannot_trade_not_allowed	[[col:red]]Cannot trade\\nThis faction does not trade.[[/col]]	false
random_localisation_strings_string_trade_status_tooltip_value	\\nCurrent value:	false
random_localisation_strings_string_trade_status_tooltip_value_potential	\\nPotential value:	false
random_localisation_strings_string_trial_empty_tier	No award held for current battle	false
random_localisation_strings_string_trial_next_award_score	|| Reach a score of %d to receive this award.	false
random_localisation_strings_string_trial_tier_reward	This will provide Daemon Prince parts as a reward.	false
random_localisation_strings_string_trials_bar_max_tooltip	Maximum award tier achieved.	false
random_localisation_strings_string_trials_bar_tooltip	Reach a score of %d to receive the next award.	false
random_localisation_strings_string_trials_bronze_tier_tooltip	Bronze Award	false
random_localisation_strings_string_trials_gold_tier_tooltip	Gold Award	false
random_localisation_strings_string_trials_platinum_tier_tooltip	Platinum Award	false
random_localisation_strings_string_trials_score_needed_for_tier	|| Reach a score of %d to receive this award.	false
random_localisation_strings_string_trials_silver_tier_tooltip	Silver Award	false
random_localisation_strings_string_tt_bloodground_active_region	Blood-Ground Region||This region is part of an active Blood-ground. The number displayed indicates the Devastation earned from razing this settlement. Devastation is also earned by winning battles in the region.	false
random_localisation_strings_string_tt_bloodground_active_region_preview	Blood-Ground Region||This region is part of an active Blood-ground. The number displayed indicates the Devastation earned from razing this settlement. Devastation is also earned by winning battles in the region.\\n\\nCreating a new Herdstone at the currently selected settlement will remove this region from its current Blood-ground and add it to the new Herdstone's Blood-ground.	false
random_localisation_strings_string_tt_bloodground_defiled_region	Defiled Blood-Ground Region||This razed region is in a Blood-ground where a Ritual of Ruin has already been performed, so is now Defiled. It cannot be colonised by any faction until the local Herdstone has been destroyed.	false
random_localisation_strings_string_tt_bloodground_defiled_region_preview	Defiled Blood-Ground Region||This razed region is in a Blood-ground where a Ritual of Ruin has already been performed, so is now Defiled. It cannot be colonised by any faction until the local Herdstone has been destroyed.\\n\\nCreating a new Herdstone at the currently selected settlement will remove this region from its current Blood-ground and add it to the new Herdstone's Blood-ground. If so, this region will no longer be considered Defiled until the Ritual of Ruin is performed again.	false
random_localisation_strings_string_tt_bloodground_devastation	Current Devastation||This is the current Devastation already earned from the surrounding Blood-ground for winning battles and razing settlements within it.\\n\\nOnce Devastation here reaches 10, the Ritual of Ruin can be performed to convert all gained Devastation into [[img:icon_marks_of_ruination]][[/img]]Marks of Ruination. More Devastation leads to more [[img:icon_marks_of_ruination]][[/img]]Marks of Ruination earned, however.	false
random_localisation_strings_string_tt_bloodground_inactive_herdstone	Potential Herdstone Region||Raising a Herdstone here will create a Blood-ground and grant the indicated Devastation, and all marked regions will also be added to its Blood-ground. Razing settlements in Blood-ground regions will grant additional Devastation, which is also granted from winning battles within them.	false
random_localisation_strings_string_tt_bloodground_inactive_region	Potential Blood-Ground Region||If a Herdstone is created at the currently selected settlement, this region will be added to its Blood-ground and the indicated amount of Devastation will be earned from razing it. Devastation would also be earned by winning battles in the region.	false
random_localisation_strings_string_tt_bloodground_other_faction	[[col:red]]This Blood-ground belongs to another Beastmen faction[[/col]]	false
random_localisation_strings_string_tt_bloodground_ritual_available	Ritual of Ruin Available||A Ritual of Ruin can now be performed here to convert the currently earned Devastation into [[img:icon_marks_of_ruination]][[/img]]Marks of Ruination. Once the ritual has been performed, other factions will be unable to colonise any ruins in the area until the Herdstone is destroyed.	false
random_localisation_strings_string_tt_bloodground_ritual_complete	Ritual of Ruin Complete||The Ritual of Ruin has already been performed for this Blood-ground. Other factions will be unable to colonise any ruins in the area until the Herdstone is destroyed.	false
random_localisation_strings_string_tt_bloodground_ritual_not_available	Ritual of Ruin Unavailable||You are unable to perform a Ritual of Ruin here until you earn 10 Devastation.\\n\\nThe Ritual of Ruin will convert local Devastation into [[img:icon_marks_of_ruination]][[/img]]Marks of Ruination. Once the ritual has been performed, other factions will be unable to colonise any ruins in the area until the Herdstone is destroyed.	false
random_localisation_strings_string_turn_mode_sequential	Sequential	false
random_localisation_strings_string_turn_mode_sim_turns	Simultaneous	false
random_localisation_strings_string_type	Type	false
random_localisation_strings_string_ultra	Ultra	false
random_localisation_strings_string_unaffordable	Unaffordable	false
random_localisation_strings_string_unavailable_in_demo	[[col:red]]Not available to play in demo[[/col]]	false
random_localisation_strings_string_undecided	Undecided	false
random_localisation_strings_string_under_repair	Under repair	false
random_localisation_strings_string_unhappy	Unhappy	false
random_localisation_strings_string_uniform_editor_custom	Custom	false
random_localisation_strings_string_unit_capture_power	Capture weight:	false
random_localisation_strings_string_unit_capture_power_description	Capture weight is how effective this unit is at capturing objectives. This number will reduce to zero as the unit loses entities.	false
random_localisation_strings_string_unit_card_lost_general_disbanded	This [[img:icon_general]][[/img]]Lord has been killed.	false
random_localisation_strings_string_unit_card_lost_hero_disbanded	text_rejected	false
random_localisation_strings_string_unit_card_lost_men_captured	This unit has been captured by the enemy.	false
random_localisation_strings_string_unit_card_lost_men_disbanded	The unit has suffered too many casualties and has been disbanded.	false
random_localisation_strings_string_unit_concerned_army_destruction	[[col:red]]Army losses[[/col]]	false
random_localisation_strings_string_unit_concerned_attacked_by_artillery	[[col:red]]Attacked by artillery[[/col]]	false
random_localisation_strings_string_unit_concerned_attacked_by_projectile	[[col:red]]Under missile fire[[/col]]	false
random_localisation_strings_string_unit_concerned_casualties	[[col:red]]Casualties sustained[[/col]]	false
random_localisation_strings_string_unit_concerned_casualties_damage	[[col:red]]Damage sustained[[/col]]	false
random_localisation_strings_string_unit_concerned_damaged_by_artillery	[[col:red]]Damaged by artillery[[/col]]	false
random_localisation_strings_string_unit_concerned_discouraged_by_unit_ability	[[col:red]]Discouraged by ability[[/col]]	false
random_localisation_strings_string_unit_concerned_enemy_controls_land	[[col:red]]The enemy is in control of the battlefield - you must attack by land![[/col]]	false
random_localisation_strings_string_unit_concerned_enemy_numbers	[[col:red]]Faster and stronger enemies nearby[[/col]]	false
random_localisation_strings_string_unit_concerned_extended_casualties	[[col:red]]Casualties sustained [[/col]]	false
random_localisation_strings_string_unit_concerned_extended_casualties_damage	[[col:red]]Damage sustained[[/col]]	false
random_localisation_strings_string_unit_concerned_fatigue_exhausted	[[col:red]]Exhaustion[[/col]]	false
random_localisation_strings_string_unit_concerned_fatigue_exhausted_construct	[[col:red]]Debilitated[[/col]]	false
random_localisation_strings_string_unit_concerned_fatigue_exhausted_undead	[[col:red]]Debilitated[[/col]]	false
random_localisation_strings_string_unit_concerned_fatigue_tired	[[col:red]]Tired[[/col]]	false
random_localisation_strings_string_unit_concerned_fatigue_tired_construct	[[col:red]]Diminished[[/col]]	false
random_localisation_strings_string_unit_concerned_fatigue_tired_undead	[[col:red]]Diminished[[/col]]	false
random_localisation_strings_string_unit_concerned_fatigue_very_tired	[[col:red]]Very tired[[/col]]	false
random_localisation_strings_string_unit_concerned_fatigue_very_tired_construct	[[col:red]]Drained[[/col]]	false
random_localisation_strings_string_unit_concerned_fatigue_very_tired_undead	[[col:red]]Drained[[/col]]	false
random_localisation_strings_string_unit_concerned_fear_enemy_unit	[[col:red]]Frightened by enemy unit[[/col]]	false
random_localisation_strings_string_unit_concerned_fighting_cavalry	[[col:red]]Fighting cavalry[[/col]]	false
random_localisation_strings_string_unit_concerned_flank_attacked	[[col:red]]Attacked in flank[[/col]]	false
random_localisation_strings_string_unit_concerned_flanks_exposed_multiple	[[col:red]]Flanks exposed[[/col]]	false
random_localisation_strings_string_unit_concerned_flanks_exposed_single	[[col:red]]Exposed flank[[/col]]	false
random_localisation_strings_string_unit_concerned_friends_routing	[[col:red]]Friends routing[[/col]]	false
random_localisation_strings_string_unit_concerned_frightened_horses	[[col:red]]Frightened horses[[/col]]	false
random_localisation_strings_string_unit_concerned_general_dead	[[col:red]]Lord dead[[/col]]	false
random_localisation_strings_string_unit_concerned_general_fled_recently	[[col:red]]Lord fled recently[[/col]]	false
random_localisation_strings_string_unit_concerned_general_incapacitated	[[col:red]]Lord incapacitated[[/col]]	false
random_localisation_strings_string_unit_concerned_general_recently_died	[[col:red]]Lord recently died[[/col]]	false
random_localisation_strings_string_unit_concerned_losing	[[col:red]]Losing currently[[/col]]	false
random_localisation_strings_string_unit_concerned_melee_contact	[[col:red]]Melee contact[[/col]]	false
random_localisation_strings_string_unit_concerned_night_battle_unprepared	[[col:red]]Unprepared for Lightning Strike battle[[/col]]	false
random_localisation_strings_string_unit_concerned_projectiles_overhead	[[col:red]]Projectiles overhead[[/col]]	false
random_localisation_strings_string_unit_concerned_rear_attacked	[[col:red]]Attacked in the rear[[/col]]	false
random_localisation_strings_string_unit_concerned_recent_casualties	[[col:red]]Recent casualties[[/col]]	false
random_localisation_strings_string_unit_concerned_recent_casualties_damage	[[col:red]]Recent damage[[/col]]	false
random_localisation_strings_string_unit_concerned_surprised	[[col:red]]Surprised by revealed enemy[[/col]]	false
random_localisation_strings_string_unit_concerned_under_friendly_fire	[[col:red]]Under friendly fire[[/col]]	false
random_localisation_strings_string_unit_encouraged_army_supported	[[col:green]]Supporting army[[/col]]	false
random_localisation_strings_string_unit_encouraged_charging	[[col:green]]Charging[[/col]]	false
random_localisation_strings_string_unit_encouraged_enemy_routing	[[col:green]]Enemy routing[[/col]]	false
random_localisation_strings_string_unit_encouraged_flanks_secure	[[col:green]]Flanks secure[[/col]]	false
random_localisation_strings_string_unit_encouraged_fortification	[[col:green]]Inside fort[[/col]]	false
random_localisation_strings_string_unit_encouraged_fortification_breach	[[col:green]]Position still defensible[[/col]]	false
random_localisation_strings_string_unit_encouraged_general_alive	[[col:green]]Lord alive[[/col]]	false
random_localisation_strings_string_unit_encouraged_general_nearby	[[col:green]]Lord nearby[[/col]]	false
random_localisation_strings_string_unit_encouraged_general_rallying_nearby	[[col:green]]Lord rallying nearby[[/col]]	false
random_localisation_strings_string_unit_encouraged_in_column_formation	[[col:green]]In column formation[[/col]]	false
random_localisation_strings_string_unit_encouraged_inspired	[[col:green]]Encouraged by nearby unit[[/col]]	false
random_localisation_strings_string_unit_encouraged_inspired_by_unit_ability	[[col:green]]Inspired by ability[[/col]]	false
random_localisation_strings_string_unit_encouraged_kills	[[col:green]]Kills inflicted on enemy[[/col]]	false
random_localisation_strings_string_unit_encouraged_on_the_hill	[[col:green]]On high ground[[/col]]	false
random_localisation_strings_string_unit_encouraged_overwhelming_friendly_units	[[col:green]]Superior local force[[/col]]	false
random_localisation_strings_string_unit_encouraged_rallied_by_unit_ability	[[col:green]]Rallied by ability[[/col]]	false
random_localisation_strings_string_unit_encouraged_settlement	[[col:green]]Defending a city[[/col]]	false
random_localisation_strings_string_unit_encouraged_settlement_plaza	[[col:green]]Defending a victory point[[/col]]	false
random_localisation_strings_string_unit_encouraged_winning	[[col:green]]Winning current combat[[/col]]	false
random_localisation_strings_string_unit_generic_left_click	Left-click to select	false
random_localisation_strings_string_unit_generic_right_click	Right-click for further information	false
random_localisation_strings_string_unit_nearly_vulnerable_to_execution	This unit is nearing the health threshold whereby they could be executed by a nearby enemy.	false
random_localisation_strings_string_unit_next_rank	Experience required for next rank	false
random_localisation_strings_string_unit_rank	Unit rank	false
random_localisation_strings_string_unit_replacement_string	replace	false
random_localisation_strings_string_unit_stat_bonus_accuracy_exceptional	Exceptional accuracy	false
random_localisation_strings_string_unit_stat_bonus_accuracy_improved	Improved accuracy	false
random_localisation_strings_string_unit_stat_bonus_accuracy_superior	Superior accuracy	false
random_localisation_strings_string_unit_stat_bonus_armour_exceptional	Exceptional armour	false
random_localisation_strings_string_unit_stat_bonus_armour_improved	Improved armour	false
random_localisation_strings_string_unit_stat_bonus_armour_superior	Superior armour	false
random_localisation_strings_string_unit_stat_bonus_charge_exceptional	Exceptional charge	false
random_localisation_strings_string_unit_stat_bonus_charge_improved	Improved charge	false
random_localisation_strings_string_unit_stat_bonus_charge_superior	Superior charge	false
random_localisation_strings_string_unit_stat_bonus_melee_exceptional	Exceptional melee	false
random_localisation_strings_string_unit_stat_bonus_melee_improved	Improved melee	false
random_localisation_strings_string_unit_stat_bonus_melee_superior	Superior melee	false
random_localisation_strings_string_unit_stat_bonus_morale_exceptional	Exceptional morale	false
random_localisation_strings_string_unit_stat_bonus_morale_improved	Improved morale	false
random_localisation_strings_string_unit_stat_bonus_morale_superior	Superior morale	false
random_localisation_strings_string_unit_stat_mass_description	Mass determines the weight of an entity for collisions and knockbacks. 	false
random_localisation_strings_string_unit_upgrade_incorrect_stance	You cannot upgrade this unit as your army is not in the correct stance.	false
random_localisation_strings_string_unit_upgrade_insufficient_funds	You do not have enough funds in your treasury to upgrade this unit.	false
random_localisation_strings_string_unit_upgrade_tooltip_cannot_afford	[[col:red]]You cannot afford this upgrade.[[/col]]	false
random_localisation_strings_string_unit_upgrade_tooltip_too_many_abilities	[[col:red]]You have reached the maximum number of abilities (6) for this unit.[[/col]]	false
random_localisation_strings_string_unit_vulnerable_to_execution	This unit is vulnerable to execution by a nearby enemy.	false
random_localisation_strings_string_unit_weight_large	The number of entities indicates the current unit size compared to the maximum possible unit size.	false
random_localisation_strings_string_unit_weight_small	{{tr:random_localisation_strings_string_unit_weight_large}}	false
random_localisation_strings_string_units	units	false
random_localisation_strings_string_units_upgrade_no_upgrade_available	There are no upgrades for this unit available.	false
random_localisation_strings_string_unknown	Unknown	false
random_localisation_strings_string_unknown_ship_state	Some of this squadron's details are unknown. Moving closer may reveal more information.	false
random_localisation_strings_string_unknown_unit_state	Some of this unit's details are unknown. Moving closer may reveal more information. [[img:icon_hero]][[/img]]Heroes have a higher chance of discerning army details.	false
random_localisation_strings_string_unknown_video_title	???	false
random_localisation_strings_string_unlimited	Unlimited	false
random_localisation_strings_string_unlock_agent_action_to_embed_in_army	[[col:red]]This [[img:icon_hero]][[/img]]Hero cannot embed into armies.[[/col]]	false
random_localisation_strings_string_up_to	%s: %s (up to %s)	false
random_localisation_strings_string_up_to_label	%s (up to %s)	false
random_localisation_strings_string_upkeep_cost	Upkeep Cost	false
random_localisation_strings_string_uses_x	Uses: %d	false
random_localisation_strings_string_valid_spell_target	Left-click to activate, Right-click to cancel.	false
random_localisation_strings_string_valid_spell_target_hp_replenish	Can replenish [[col:green]]%d[[/col]] more [[img:icon_hp]][[/img]]hit points of target.	false
random_localisation_strings_string_valid_spell_target_manual_aim	Hold down ALT to manually aim.	false
random_localisation_strings_string_valid_spell_target_vortex_aim	Hold left mouse button and drag to rotate.	false
random_localisation_strings_string_version	Version	false
random_localisation_strings_string_versus	vs.	false
random_localisation_strings_string_very_hard	Very Hard	false
random_localisation_strings_string_victory	Victory	false
random_localisation_strings_string_wagh_unit_marker_tooltip	Waaagh! Unit||This unit has responded to a Call to Waaagh! and will only be present for the duration of the Waaagh!	false
random_localisation_strings_string_wall_strength	Wall strength	false
random_localisation_strings_string_warning_ancillary_swap	This item or follower is currently assigned to %S. Are you sure want to remove and reassign it to this character?	false
random_localisation_strings_string_warning_dirty_exit_body	Players who repeatedly drop out of quick battles might be exploiting the game to avoid a loss.\\nIf you quit out of quick battles too often or too frequently you will suffer a loss of points.	false
random_localisation_strings_string_warning_dirty_exit_title	[[col:dark_r]]Warning: The last quick battle was quit irregularly or crashed[[/col]]	false
random_localisation_strings_string_warning_graphics_upgrade	Some settings may not be applied until the next time a campaign or battle is launched. Continue?	false
random_localisation_strings_string_warning_players_without_dlc	You are about to select map containing DLC content that some players in the lobby do not own. This will result in them being kicked. Do you wish to proceed?	false
random_localisation_strings_string_warning_shadowy_dealings_character_convalescing	The character will be taken off the map for a few turns, if leading an army the character will have to be replaced. Are you sure you want to send this character on this action?	false
random_localisation_strings_string_weakness_fire	Fire Weakness: %d%%||Damage of [[img:ui/skins/default/modifier_icon_flaming.png]][[/img]]flaming attacks is increased by this amount.	false
random_localisation_strings_string_weakness_fire_tooltip	[[col:red]]Fire Weakness: %d%%||Damage of [[img:ui/skins/default/modifier_icon_flaming.png]][[/img]]flaming attacks is increased by this amount.[[/col]]	false
random_localisation_strings_string_wealth	Wealth	false
random_localisation_strings_string_wealth_category_1	Spectacular	false
random_localisation_strings_string_wealth_category_2	Rich	false
random_localisation_strings_string_wealth_category_3	Affluent	false
random_localisation_strings_string_wealth_category_4	Moderate	false
random_localisation_strings_string_wealth_category_5	Meagre	false
random_localisation_strings_string_wealth_category_6	Destitute	false
random_localisation_strings_string_weather_storm	Sandstorm	false
random_localisation_strings_string_weather_tooltips_dry	Dry||No adverse effects.	false
random_localisation_strings_string_weather_tooltips_fog	Fog||Reduced visibility. All ships and missile units fire with reduced accuracy and range, and enemy units are concealed by fog at long distances.	false
random_localisation_strings_string_weather_tooltips_rain	Rain||Archers may not use flaming arrows. It is more difficult to set fire to buildings and ships, and units take longer to recover from fatigue when idle.	false
random_localisation_strings_string_weather_tooltips_snow	Snow||Units take longer to recover from fatigue when idle.	false
random_localisation_strings_string_weather_tooltips_storm	Sandstorm|| It takes more to ignite ships, buildings, and deployable defences.	false
random_localisation_strings_string_wh2_dlc09_lock_casket_of_souls	[[col:red]]This unit will become available after performing the Rite of the Great Incantation of Tahoth.[[/col]]	false
random_localisation_strings_string_wh2_dlc09_lock_ror_crafting	[[col:red]]This unit will become available after first crafting it in the Mortuary Cult.[[/col]]	false
random_localisation_strings_string_wh3_dlc24_formless_horror_no_forms	No Forms to Show	false
random_localisation_strings_string_wh3_dlc24_formless_horror_search_forms	Search Forms	false
random_localisation_strings_string_wh3_dlc26_reoccupation_immunity_major_settlement_first_line_tooltip	Devastated Major settlement	false
random_localisation_strings_string_wh3_dlc26_reoccupation_immunity_minor_settlement_first_line_tooltip	Devastated Minor settlement	false
random_localisation_strings_string_wh3_dlc26_reoccupation_immunity_settlement_third_line_tooltip	This settlement cannot be interacted with while devastated.	false
random_localisation_strings_string_wh3_prologue_discovered_settlement	Settlement Discovered	false
random_localisation_strings_string_wh3_prologue_loading_screen_battle1_intro_text_01	The Beacon is under attack. Kislevites loyal to the Motherland are within. Our army is small, but we can sway the battle if we are as wise as Ursun. We approach from the south, while Skollden's Northmen assault the barricades. Their backs are to us. We should take advantage.	false
random_localisation_strings_string_wh3_prologue_loading_screen_battle1_outro_text_01	The Beacon is safe. Many lives have been spared. The survivors look to me for leadership. I will need them, for the Wolf still lurks in the shadows.	false
random_localisation_strings_string_wh3_prologue_loading_screen_battle2_intro_text_01	The Wolf is cunning. He waited, knowing we would come this way. Now he means to face us in open battle with renewed strength. We deploy on the high ground and make him come to us!	false
random_localisation_strings_string_wh3_prologue_loading_screen_battle2_outro_text_01	The Wolf routs from the battlefield! He takes the remnants of his tattered force and flees north, into the wilderness.	false
random_localisation_strings_string_wh3_prologue_loading_screen_brazen_altar_intro_text_01	While Khorne cares not from whom the blood flows, the Daemonic guardians of the Brazen Altar want it to be ours. Hungry for war, they will come at us directly. This knowledge must inform my strategy.	false
random_localisation_strings_string_wh3_prologue_loading_screen_brazen_altar_outro_text_01	Who cares if my soldiers conspire and whisper doubts … I descend… and approach the Brazen Altar alone.	false
random_localisation_strings_string_wh3_prologue_loading_screen_dervingard_intro_text_01	Dervingard was built to defy the Dark Powers and prevent another Great War Against Chaos. But the stronghold has fallen into ruin, blackened by those that defile its halls. It has become the den of the Wolf.	false
random_localisation_strings_string_wh3_prologue_loading_screen_dervingard_outro_text_01	As the last enemy drew their final breath, a single ray of sunlight broke through the greyest of clouds. Dervingard was free.	false
random_localisation_strings_string_wh3_prologue_loading_screen_howling_citadel_intro_text_01	Kurnz, once a Boyar of Dervingard, now a Warlord of Chaos, marshals an alliance of tribes dedicated to the Dark Powers. They will stop at nothing to prevent me from taking the Howling Citadel. The Chaos forces surround us – I must fight.	false
random_localisation_strings_string_wh3_prologue_loading_screen_howling_citadel_outro_text_01	The traitor dies. The path to the Howling Citadel is open…	false
random_localisation_strings_string_wh3_prologue_loading_screen_lucent_maze_intro_text_01	The knowledge to reach Ursun lies hidden in the Lucent Maze. The servants of Tzeentch defend it, but it's not them I fear. Mortals that enter the labyrinth rarely emerge with their minds intact. I pray Ursun protects me.	false
random_localisation_strings_string_wh3_prologue_loading_screen_lucent_maze_outro_text_01	With Tzeentch’s forces scattered, I can walk willingly into the Lucent Maze. The knowledge within can lead us to the Howling Citadel.	false
random_localisation_strings_string_wh3_prologue_new_objective	New Objective	false
random_localisation_strings_string_wh3_prologue_objectives_screen_title	Missions	false
random_localisation_strings_string_wh3_prologue_pre_battle_battle_1_description	Battle is upon us! The Wolf unleashes his pack of savages against Kislevian brothers and sisters. Save the Beacon and slay these northern dogs!	false
random_localisation_strings_string_wh3_prologue_pre_battle_battle_1_title	The Battle of the Beacon	false
random_localisation_strings_string_wh3_prologue_pre_battle_battle_2_title	Skollden Attacks! 	false
random_localisation_strings_string_wh3_prologue_pre_battle_brazen_altar_title	The Brazen Altar	false
random_localisation_strings_string_wh3_prologue_pre_battle_dervingard_title	Battle for Dervingard	false
random_localisation_strings_string_wh3_prologue_pre_battle_howling_citadel_title	The Howling Citadel	false
random_localisation_strings_string_wh3_prologue_pre_battle_lucent_maze_title	The Lucent Maze	false
random_localisation_strings_string_whisper	Private Message	false
random_localisation_strings_string_will_draw_at_end	You will draw if the time runs out	false
random_localisation_strings_string_will_lose_at_end	You will lose if the time runs out	false
random_localisation_strings_string_will_win_at_end	You will win if the time runs out	false
random_localisation_strings_string_win_chance_high	High	false
random_localisation_strings_string_win_chance_low	Low	false
random_localisation_strings_string_win_chance_moderate	Moderate	false
random_localisation_strings_string_win_chance_none	None	false
random_localisation_strings_string_win_chance_very_high	Very High	false
random_localisation_strings_string_winds_of_magic_strength	[[img:ui/skins/default/icon_mana.png]][[/img]]Winds of Magic	false
random_localisation_strings_string_x_out_of_y_int	%d/%d	false
random_localisation_strings_string_x_seconds	(%ds)	false
random_localisation_strings_string_yes	Yes	false
random_localisation_strings_string_you	You	false
random_localisation_strings_string_you_cannot_afford_to_repair_this_item	[[col:red]]You cannot afford to repair this building.\\nCost: {{tr:icon_treasury}} %d [[/col]]	false
random_localisation_strings_string_your_ally	Your ally: 	false
