key	text	tooltip
#Loc;1;text/db/scripted_subtitles__.loc		
scripted_subtitles_localised_text_Nor_Throgg_Final_Battle_vs_Crow_pt_01	 So, the Crow-God seeks to test me... Yet He merely brings me another feast.	false
scripted_subtitles_localised_text_Nor_Throgg_Final_Battle_vs_Crow_pt_02	Such pungency here… an aroma that cannot merely be the Crow’s virulent musk.	false
scripted_subtitles_localised_text_Nor_Throgg_Final_Battle_vs_Crow_pt_03	How he disappoints me with cheap tricks. Today I dine on His puppets!	false
scripted_subtitles_localised_text_Nor_Throgg_Final_Battle_vs_Eagle_pt_01	A most predictable move from the Eagle... But, not an unwelcome one. Like a puppet master at play, He summons forth a Champion.	false
scripted_subtitles_localised_text_Nor_Throgg_Final_Battle_vs_Eagle_pt_02	A gangly morsel that has his master’s protection, for now… but that will not save him from our gullets.	false
scripted_subtitles_localised_text_Nor_Throgg_Final_Battle_vs_Eagle_pt_03	Let all who face the Monstrous Horde feel the icy wrath of Troll Country.	false
scripted_subtitles_localised_text_Nor_Throgg_Final_Battle_vs_Hound_pt_01	So comes the acolyte of the Hound God, we shall give Him the fight He so craves! Show Him who’s the predator… and who’s the prey.	false
scripted_subtitles_localised_text_Nor_Throgg_Final_Battle_vs_Hound_pt_02	Behold, Hound. Watch your thralls be crushed under the might of the Monstrous Horde.	false
scripted_subtitles_localised_text_Nor_Throgg_Final_Battle_vs_Serpent_pt_01	My slavering subjects, our moment of glory beckons... yet our rise turns the gaze of the envious gods.	false
scripted_subtitles_localised_text_Nor_Throgg_Final_Battle_vs_Serpent_pt_02	The Serpent beckons us to where agony and glory are separated by a hair's breadth.	false
scripted_subtitles_localised_text_Nor_Throgg_Final_Battle_vs_Serpent_pt_03	Battle... where He shall revel in the pain of His own Champion, crushed underfoot!	false
scripted_subtitles_localised_text_Nor_Throgg_QB_Wintertooth_Crown_pt_01	No doubt this Dwarf presumed to steal from a witless beast. But he shall learn -	false
scripted_subtitles_localised_text_Nor_Throgg_QB_Wintertooth_Crown_pt_02	oh, yes, he shall learn - the cost of such ignorance! Answer this insult with DEATH!	false
scripted_subtitles_localised_text_Nor_Throgg_QB_Wintertooth_Crown_pt_03	Show him the ravenous hunger of the Monstrous Horde! I want to watch the regret in his eyes as we tear him limb from limb!	false
scripted_subtitles_localised_text_Nor_Wulfrik_Final_Battle_vs_Crow_pt_01	What a compliment! Although the other Ruinous Ones show us no favour, they at least grant us recognition! The followers of the Crow dare stand before us as an affront to our Master.	false
scripted_subtitles_localised_text_Nor_Wulfrik_Final_Battle_vs_Crow_pt_02	We have shunned their God, and for that they consider us a threat - and so they should!	false
scripted_subtitles_localised_text_Nor_Wulfrik_Final_Battle_vs_Crow_pt_03	Our victories prove the Master’s dominance! Now we will show them what a threat we really are – we shall drown them in their own blood and guts! Glory to the Master!!!	false
scripted_subtitles_localised_text_Nor_Wulfrik_Final_Battle_vs_Eagle_pt_01	Look at that despicable cabal of Eagle God worshippers across the way, with their craven champion! I fear no champion, I only destroy them!	false
scripted_subtitles_localised_text_Nor_Wulfrik_Final_Battle_vs_Eagle_pt_02	And you, the warriors and twisted beasts of my army, have slain many with me in the name of our Dark Master.	false
scripted_subtitles_localised_text_Nor_Wulfrik_Final_Battle_vs_Eagle_pt_03	Make no mistake - he still watches us!	false
scripted_subtitles_localised_text_Nor_Wulfrik_Final_Battle_vs_Eagle_pt_04	May the bodies continue to fall! May their limbs be torn from their torsos! May the battlefield be soaked red with their blood!!!	false
scripted_subtitles_localised_text_Nor_Wulfrik_Final_Battle_vs_Hound_pt_01	The bodies of enemies slain have paved a bloody path, drenched in gore, by the will of our master; the trail has led us here today!	false
scripted_subtitles_localised_text_Nor_Wulfrik_Final_Battle_vs_Hound_pt_02	Now the tidal wave of blood we've spilt has drawn the attention of the Hound’s twisted followers. They stand across the way with their weakling champion, 	false
scripted_subtitles_localised_text_Nor_Wulfrik_Final_Battle_vs_Hound_pt_03	attempting to summon yet more cretins. I will take his skull, and together we will wipe out every one of them! To the slaughter!!!	false
scripted_subtitles_localised_text_Nor_Wulfrik_Final_Battle_vs_Serpent_pt_01	Fellow raiders! Together we have destroyed realms, torn down the feeble cities of the weak, and proven ourselves worthy, worthy in the eyes of our Master.	false
scripted_subtitles_localised_text_Nor_Wulfrik_Final_Battle_vs_Serpent_pt_02	We have the attention of the other Gods; they feel threatened by us! And what a dark blessing it is! It is proof of the Master's favour! 	false
scripted_subtitles_localised_text_Nor_Wulfrik_Final_Battle_vs_Serpent_pt_03	Look at the Serpent-followers... those sensation-seekers and self-obsessed cowards! 	false
scripted_subtitles_localised_text_Nor_Wulfrik_Final_Battle_vs_Serpent_pt_04	They stand trembling over there with their champion, still trying to summon more help. Let’s make their corpses a bloody offering of our own!!!	false
scripted_subtitles_localised_text_Nor_Wulfrik_QB_Sword_of_Torgald_pt_01	Tribesmen, again it is time to soak our blades in the blood of weak southerners!	false
scripted_subtitles_localised_text_Nor_Wulfrik_QB_Sword_of_Torgald_pt_02	Pompous and proud, yet they don’t even give me the courtesy of a worthy fight. I come here seeking champions, but look – they send peasants!	false
scripted_subtitles_localised_text_Nor_Wulfrik_QB_Sword_of_Torgald_pt_03	Their cowardly Lords don’t deserve their riches, so we shall kill them and take all that we see.	false
scripted_subtitles_localised_text_Nor_Wulfrik_QB_Sword_of_Torgald_pt_04	Then, the rest of Bretonnia! My Masters will receive these offerings by my sword! Kill at will!!!	false
scripted_subtitles_localised_text_cat_miao_ying_bat_speeches_01	Once more the Bastion is under attack, once more the honour of its defence falls to me. I will not let you down, father!	false
scripted_subtitles_localised_text_cat_miao_ying_bat_speeches_02	They offer only disharmony and darkness, while I bring order and light. Together we shall defend these walls, sell our lives if we must. Ready your weapons!	false
scripted_subtitles_localised_text_cat_miao_ying_bat_speeches_03	Perhaps one day the Great Bastion will fall, but not this day. No, it is the forces of disharmony that shall fall – to our blades! 	false
scripted_subtitles_localised_text_cat_miao_ying_bat_speeches_04	My father, the Celestial Dragon Emperor, watches us! Defend the bastion under his gaze, and you will find his favour! Strength and honour is yours to take! 	false
scripted_subtitles_localised_text_cat_miao_ying_bat_speeches_05	The Ruinous Powers knock upon our gates, but these guests are not welcome! Send them from our threshold with the steel in your hands and in your hearts!	false
scripted_subtitles_localised_text_cat_zhao_ming_bat_speeches_01	If my sister is found delinquent in her duty, then we defend the Bastion, and ensure the invading scum shall not set foot in my parent's domain!	false
scripted_subtitles_localised_text_cat_zhao_ming_bat_speeches_02	Mother has forewarned me… Chaos attempts to breach the Bastion, and so I bring the might of the Western Provinces to thwart them! Ready your arms!	false
scripted_subtitles_localised_text_cat_zhao_ming_bat_speeches_03	The Dark Powers assault my father's walls, but it is mother who tasks me to clear them of filth! So it shall be, for I am Zhao Ming!	false
scripted_subtitles_localised_text_cat_zhao_ming_bat_speeches_04	Ah, the Great Bastion! I should be its master, let me prove to my parents why. Ready your weapons, my followers, purge the walls of Chaos!	false
scripted_subtitles_localised_text_cat_zhao_ming_bat_speeches_05	Chaos comes. But we will not be found wanting. Defend this place and earn me honour, for that is your role in this pantomime!	false
scripted_subtitles_localised_text_dlc09_qb_skv_tretch_craventail_lucky_skullhelm_stage_5_intro_01	Cease your squeaking and groom yourselves for battle, rodents of Clan Rictus, for the enemy come into sight!	false
scripted_subtitles_localised_text_dlc09_qb_skv_tretch_craventail_lucky_skullhelm_stage_5_intro_02	The green no-furs sit upwind, unaware of our approach! Look-see how the block-headed fools send their patrols away! A-ha-ha!	false
scripted_subtitles_localised_text_dlc09_qb_skv_tretch_craventail_lucky_skullhelm_stage_5_intro_03	Lucky-us, yes-yes! We attack while they are weak! We leave only their bones, ha-ha!	false
scripted_subtitles_localised_text_esc_to_skip_cutscene	Press ESC to continue	false
scripted_subtitles_localised_text_topic_leader_new_objective	New Objective	false
scripted_subtitles_localised_text_topic_leader_new_topic	New Topic	false
scripted_subtitles_localised_text_wh2_dlc09_qb_skv_tretch_craventail_final_battle_pt_01	Scribe-slave squeaks wise words-noises!	false
scripted_subtitles_localised_text_wh2_dlc09_qb_skv_tretch_craventail_final_battle_pt_02	Clan Rictus now-now most powerful, under Horned Rat I will be more than mere Chief of Deep Warrens, even better-superior title, yes-yes!	false
scripted_subtitles_localised_text_wh2_dlc09_qb_skv_tretch_craventail_final_battle_pt_03	Forward rodents of Rictus: the Elf-thing island ours, Vortex OURS!	false
scripted_subtitles_localised_text_wh2_dlc09_qb_skv_tretch_craventail_final_battle_pt_04	*Meeker* (Let me just go and take a look-strategise from this vantage point far-far over here…)	false
scripted_subtitles_localised_text_wh2_dlc09_qb_tmb_arkhan_the_staff_of_nagash_stage_5_staff_of_nagash_part_01	So, the "Great Settra" sends his champion to thwart my course, does he? 	false
scripted_subtitles_localised_text_wh2_dlc09_qb_tmb_arkhan_the_staff_of_nagash_stage_5_staff_of_nagash_part_02	Perhaps he thinks me some princeling, to be swatted aside by such an inferior. 	false
scripted_subtitles_localised_text_wh2_dlc09_qb_tmb_arkhan_the_staff_of_nagash_stage_5_staff_of_nagash_part_03	Better you had come yourself, Settra! The Staff of Nagash will be mine, and your servant's head will be returned on a spike! Haaah!	false
scripted_subtitles_localised_text_wh2_dlc09_qb_tmb_arkhan_the_tomb_blade_of_arkhan_stage_4_mortuary_of_tzulaqua_part_01	Come, loyal thralls! Today, we do Nagash's work. 	false
scripted_subtitles_localised_text_wh2_dlc09_qb_tmb_arkhan_the_tomb_blade_of_arkhan_stage_4_mortuary_of_tzulaqua_part_02	This pathetic rabble of reptiles presume to master the arts of resurrection!	false
scripted_subtitles_localised_text_wh2_dlc09_qb_tmb_arkhan_the_tomb_blade_of_arkhan_stage_4_mortuary_of_tzulaqua_part_03	Their pitiful knowledge of such matters will die with them, here before the statues of the gods!	false
scripted_subtitles_localised_text_wh2_dlc09_qb_tmb_arkhan_the_tomb_blade_of_arkhan_stage_4_mortuary_of_tzulaqua_part_04	Slay them all! Bring me Alcadizaar's remains! My Tomb Blade will burn with the light of Nagash!	false
scripted_subtitles_localised_text_wh2_dlc09_qb_tmb_khalida_venom_staff_stage_3_ash_river_pt_01	Since time out of mind, the Vampire thralls of my warped cousin have blighted Nehekhara.	false
scripted_subtitles_localised_text_wh2_dlc09_qb_tmb_khalida_venom_staff_stage_3_ash_river_pt_02	Today, we burn out that blight. Hear me, O Asaph! This slaughter I offer in your name!	false
scripted_subtitles_localised_text_wh2_dlc09_qb_tmb_khalida_venom_staff_stage_3_ash_river_pt_03	May your venom flow in the sacred staff, that I may shatter your adversaries for all eternity!	false
scripted_subtitles_localised_text_wh2_dlc09_qb_tmb_khatep_the_liche_staff_stage_5_pits_of_zardok_part_01	The followers of Nagash have woven a web of deceit designed to entrap me, like a Tomb Scorpion waiting under the sands for prey…	false
scripted_subtitles_localised_text_wh2_dlc09_qb_tmb_khatep_the_liche_staff_stage_5_pits_of_zardok_part_02	But I am no quarry! Let these bestial fleshlings come! 	false
scripted_subtitles_localised_text_wh2_dlc09_qb_tmb_khatep_the_liche_staff_stage_5_pits_of_zardok_part_03	They will witness sand and stone, they shall see the true might of the Mortuary Cult; the true masters of Undeath, the Liches of Khemri!	false
scripted_subtitles_localised_text_wh2_dlc09_qb_tmb_settra_the_blessed_blade_of_ptra_stage_3_charnel_valley_part_01	I alone may wield the Blessed Blade of Ptra. For am I not his right-hand, the Bringer of the Fires of the Sun?	false
scripted_subtitles_localised_text_wh2_dlc09_qb_tmb_settra_the_blessed_blade_of_ptra_stage_3_charnel_valley_part_02	Today, I offer him a fine tribute indeed - a thousand souls or more, each an idolater, a heathen, and an enemy of Nehekhara. 	false
scripted_subtitles_localised_text_wh2_dlc09_qb_tmb_settra_the_blessed_blade_of_ptra_stage_3_charnel_valley_part_03	May this please you, mighty Ptra, bringer of the day, for it is the last these unbelievers will ever see!	false
scripted_subtitles_localised_text_wh2_dlc09_tmb_arkhan_qb_final_battle_01	My master, your Black Pyramid is ready.	false
scripted_subtitles_localised_text_wh2_dlc09_tmb_arkhan_qb_final_battle_02	I do not claim this, I am merely its steward; a warden to keep your shrine ready for your inevitable resurrection	false
scripted_subtitles_localised_text_wh2_dlc09_tmb_arkhan_qb_final_battle_03	A necessary task, for even now the feeble Tomb Kings gather to steal your majesty!	false
scripted_subtitles_localised_text_wh2_dlc09_tmb_arkhan_qb_final_battle_04	Settra sends all Nehekhara against us, but with your staff in hand they are doomed to fail!	false
scripted_subtitles_localised_text_wh2_dlc09_tmb_khalida_qb_final_battle_01	I care not for this Pyramid. Unlike others, it is not power I seek, but vengeance.	false
scripted_subtitles_localised_text_wh2_dlc09_tmb_khalida_qb_final_battle_02	This is a tool, nothing more. It is a gift to Asaph, and in her name I shall hunt the whores of Lahmia!	false
scripted_subtitles_localised_text_wh2_dlc09_tmb_khalida_qb_final_battle_03	So, my legions, banish this Liche King, he is in our way!	false
scripted_subtitles_localised_text_wh2_dlc09_tmb_khatep_qb_final_battle_01	For too long the Mortuary Cult has fallen into the Arch-Necromancer’s shadow.	false
scripted_subtitles_localised_text_wh2_dlc09_tmb_khatep_qb_final_battle_02	But Nagash has gone from this world, and if we claim the Black Pyramid we will ensure he can never return!	false
scripted_subtitles_localised_text_wh2_dlc09_tmb_khatep_qb_final_battle_03	The lore within shall show us the true path to the Day of Awakening – now is the dawn of the Mortuary Cult!	false
scripted_subtitles_localised_text_wh2_dlc09_tmb_khatep_qb_final_battle_04	Yes, yes! Banish the Liche King – we are exiles no longer!	false
scripted_subtitles_localised_text_wh2_dlc09_tmb_settra_qb_final_battle_pt_01	The Black Pyramid rises. It is time for the Great King to ascend to a new throne.	false
scripted_subtitles_localised_text_wh2_dlc09_tmb_settra_qb_final_battle_pt_02	But Arkhan attempts to frustrate me, proving finally that blind loyalty to a perished conjurer will be his doom.	false
scripted_subtitles_localised_text_wh2_dlc09_tmb_settra_qb_final_battle_pt_03	Forward my legions, I will have Nagash’s pyramid – Settra dominates ALL!	false
scripted_subtitles_localised_text_wh2_dlc09_tmb_settra_the_crown_of_nehekhara_stage_5_pack_ice_bay_part_01	Today we dispatch these faithless barbarians, these petty thieves, in tribute to Djaf, the God of War and Death.	false
scripted_subtitles_localised_text_wh2_dlc09_tmb_settra_the_crown_of_nehekhara_stage_5_pack_ice_bay_part_02	He will feast as the jackal does and grow fat on their souls. For who dares stand before Settra in defiance of his will? 	false
scripted_subtitles_localised_text_wh2_dlc09_tmb_settra_the_crown_of_nehekhara_stage_5_pack_ice_bay_part_03	I am the King of Kings, the Imperishable. And I will see my crown returned!	false
scripted_subtitles_localised_text_wh2_dlc10_qb_def_hellebron_deathsword_and_the_cursed_blade_stage_4_intro_01	Hear me Khaine, I dedicate all the following deaths to you. Give me your bloody hand so I may hold it and let it guide me to victory!	false
scripted_subtitles_localised_text_wh2_dlc10_qb_def_hellebron_deathsword_and_the_cursed_blade_stage_4_intro_02	My retainers advise caution, but I am no coward... The first slash is the sweetest and I always strike first!	false
scripted_subtitles_localised_text_wh2_dlc10_qb_def_hellebron_final_battle_pt_01	Fine! Let Malekith have the Vortex!	false
scripted_subtitles_localised_text_wh2_dlc10_qb_def_hellebron_final_battle_pt_02	He will forever be in my debt and such mundane power does not interest me.	false
scripted_subtitles_localised_text_wh2_dlc10_qb_def_hellebron_final_battle_pt_03	But I will take the murder of all the ratmen and the slaying of their Horned God.	false
scripted_subtitles_localised_text_wh2_dlc10_qb_def_hellebron_final_battle_pt_04	That will be mine – and I dedicate it all to Khaine! Let the slaughter begin!	false
scripted_subtitles_localised_text_wh2_dlc10_qb_hef_alarielle_final_battle_pt_01	I feel the pain of those within the Vortex.	false
scripted_subtitles_localised_text_wh2_dlc10_qb_hef_alarielle_final_battle_pt_02	The torment of Caledor Dragontamer as he and his brothers wrestle to keep Ulthuan afloat.	false
scripted_subtitles_localised_text_wh2_dlc10_qb_hef_alarielle_final_battle_pt_03	We will aid them – salve their woes and stop this rat-god from entering the world!	false
scripted_subtitles_localised_text_wh2_dlc10_qb_hef_alarielle_final_battle_pt_04	Asur to your queen! Defend the Vortex!	false
scripted_subtitles_localised_text_wh2_dlc10_qb_hef_alarielle_star_of_avelorn_stage_5_intro_01	Silence, my sisters! We work covertly. As Isha looks from upon high so shall we look down on these mortal puppets by taking the higher ground.	false
scripted_subtitles_localised_text_wh2_dlc10_qb_hef_alarielle_star_of_avelorn_stage_5_intro_02	Then we shall slay them all bar one. I will look in the eye of this last surviving foe and he will not bear falsehood. He will tell me how to lift the curse on Avelorn's star.	false
scripted_subtitles_localised_text_wh2_dlc10_qb_hef_alarielle_star_of_avelorn_stage_5_intro_03	Now, away, my host! Begin the toil!	false
scripted_subtitles_localised_text_wh2_dlc10_qb_hef_alith_anar_final_battle_pt_01	The Loremaster speaks truth. There is a cancer at the heart of Ulthuan.	false
scripted_subtitles_localised_text_wh2_dlc10_qb_hef_alith_anar_final_battle_pt_02	And if it is not halted, the fate of all Asur will match Nagarythe.	false
scripted_subtitles_localised_text_wh2_dlc10_qb_hef_alith_anar_final_battle_pt_03	We cannot let Ulthuan be consumed in sea and shadow. We must stop this vermin-god at all costs.	false
scripted_subtitles_localised_text_wh2_dlc10_qb_hef_alith_anar_final_battle_pt_04	Follow me loyal kin, now is our final fate – glory or defeat!	false
scripted_subtitles_localised_text_wh2_dlc10_qb_hef_alith_anar_the_moon_bow_stage_4_intro_01	The Druchii scum seek to trap us. The fools think it is easy to snare the shadows! Disabuse them of this notion.	false
scripted_subtitles_localised_text_wh2_dlc10_qb_hef_alith_anar_the_moon_bow_stage_4_intro_02	We shall show these followers of the weak-willed brat; the mummy’s boy that couldn’t even tame a candle flame in the shrine of Asuryan!	false
scripted_subtitles_localised_text_wh2_dlc10_qb_hef_alith_anar_the_moon_bow_stage_4_intro_03	I need to fill my quiver, then the Moonbow can sing again – so let these Druchii mongrels come!	false
scripted_subtitles_localised_text_wh2_dlc11_Aranessa_Saltspite_QB_Krakens_Bane_pt_01	My father calls, not this Norse puppet who claims ownership simply because he spilt his seed… 	false
scripted_subtitles_localised_text_wh2_dlc11_Aranessa_Saltspite_QB_Krakens_Bane_pt_02	No, my real sire… the Seafather! Let the forces of the false begetter crash uselessly against the cliffs, like waves against the Swordfysh's hull!	false
scripted_subtitles_localised_text_wh2_dlc11_Aranessa_Saltspite_QB_Krakens_Bane_pt_03	Cutlasses out! Blood and salt!	false
scripted_subtitles_localised_text_wh2_dlc11_CylostaDirefin_QB_Bordeleaux_Flabellum_alt_pt_01	Ahhhhhhhhhhhhh… what joy do these gleaming spear-wielders bring, for now there is a chance for me to sing, and then they shall escort to their seafaring king… 	false
scripted_subtitles_localised_text_wh2_dlc11_CylostaDirefin_QB_Bordeleaux_Flabellum_alt_pt_02	But before then, I’ll have to be crass and make these unfortunate souls stare at my looking glass.	false
scripted_subtitles_localised_text_wh2_dlc11_CylostaDirefin_QB_Bordeleaux_Flabellum_pt_01	Ahhhhhhhhhhhhh… whom do I spy, whom do I see? It is the glorious, doomed Knights of Chivalry.	false
scripted_subtitles_localised_text_wh2_dlc11_CylostaDirefin_QB_Bordeleaux_Flabellum_pt_02	For these unfortunate souls shall not get a pass as I force them gaze into my looking glass!	false
scripted_subtitles_localised_text_wh2_dlc11_Lokhir_Fellheart_QB_Helm_Of_Kraken_pt_01	Steady, my Corsairs, the Skaven come - they think to board my tower in secret, but no creature steps upon the Blessed Dread without my knowing.	false
scripted_subtitles_localised_text_wh2_dlc11_Lokhir_Fellheart_QB_Helm_Of_Kraken_pt_02	The rodent-sorcerer sends his minions, but this is no sinking ship. No rats are welcome here! 	false
scripted_subtitles_localised_text_wh2_dlc11_Lokhir_Fellheart_QB_Helm_Of_Kraken_pt_03	Be merciless! The Kraken rumbles. My helm thirsts for the power it lacks, and these vermin filth will quench it.	false
scripted_subtitles_localised_text_wh2_dlc11_Lokhir_Fellheart_VC_Final_Battle_pt_01	Your hunt is over. The Merwyrm is not yours to slay. It is a creature of Mathlann, Lord of the Deeps, and only I am charged to cull in His name.	false
scripted_subtitles_localised_text_wh2_dlc11_Lokhir_Fellheart_VC_Final_Battle_pt_02	It has been amusing watching your sea-wracked corpses stumble and dodder as you tracked the prey, but Amanar is Lothern’s guardian, a creature aligned to the Asur.	false
scripted_subtitles_localised_text_wh2_dlc11_Lokhir_Fellheart_VC_Final_Battle_pt_03	Who are you to interfere in such an ancient rivalry? The prize is mine and mine alone!	false
scripted_subtitles_localised_text_wh2_dlc11_Lokhir_Fellheart_VC_Final_Battle_pt_04	The beast is summoned, your use is at an end!	false
scripted_subtitles_localised_text_wh2_dlc11_Lokhir_Fellheart_VC_Final_Battle_pt_05	Prepare to face the Krakenlord!	false
scripted_subtitles_localised_text_wh2_dlc11_qb_cst_harkon_quest_for_slann_gold_stage_4_intro_01	That mob of reptilian scoundrels travelled far for their precious gold… it must be important…	false
scripted_subtitles_localised_text_wh2_dlc11_qb_cst_harkon_quest_for_slann_gold_stage_4_intro_02	What are they hiding? What secrets does it contain? The Winds of Magic have shunned me for too long, my thoughts constantly at odds with one another.	false
scripted_subtitles_localised_text_wh2_dlc11_qb_cst_harkon_quest_for_slann_gold_stage_4_intro_03	All the while, those bulbous Slann toad-priests conjure great spells for their futile causes.	false
scripted_subtitles_localised_text_wh2_dlc11_qb_cst_harkon_quest_for_slann_gold_stage_4_intro_04	Now they hide behind a glyph-enchanted tower. I must reconnect with my powers… I must silence the voices in my head!	false
scripted_subtitles_localised_text_wh2_dlc11_qb_cst_harkon_quest_for_slann_gold_stage_4_intro_05	Forward, deckhands! Bring me that Slann Gold, or I’ll send you back to your watery graves!	false
scripted_subtitles_localised_text_wh2_dlc11_qb_cst_noctilus_captain_roths_moondial_stage_4_intro_01	The peons of the Empire dare lay their hands on the chest I seek!	false
scripted_subtitles_localised_text_wh2_dlc11_qb_cst_noctilus_captain_roths_moondial_stage_4_intro_02	These cattle are ignorant of what they now possess, but they will not live long enough to find out!	false
scripted_subtitles_localised_text_wh2_dlc11_qb_cst_noctilus_captain_roths_moondial_stage_4_intro_03	Roth’s Moondial cannot elude me any longer. It is only a matter of time before another rival uses it to gain access to the Galleon’s Graveyard.	false
scripted_subtitles_localised_text_wh2_dlc11_qb_cst_noctilus_captain_roths_moondial_stage_4_intro_04	Only I, Count Noctilus, am worthy of the Maelstrom’s boundless power!	false
scripted_subtitles_localised_text_wh2_dlc11_qb_cst_noctilus_captain_roths_moondial_stage_4_intro_05	Only I can rule the Great Ocean and the waters beyond!	false
scripted_subtitles_localised_text_wh2_dlc11_qb_def_lokhir_final_battle_pt_01	The Vortex lies at the heart of Ulthuan. It interests me little. 	false
scripted_subtitles_localised_text_wh2_dlc11_qb_def_lokhir_final_battle_pt_02	Let Malekith have it, for he has promised me Ulthuan’s coasts!	false
scripted_subtitles_localised_text_wh2_dlc11_qb_def_lokhir_final_battle_pt_03	And when they sink, I have been commissioned to collect and enslave all Asur hiding in their precious colonies. The spoils and infamy will be legendary!	false
scripted_subtitles_localised_text_wh2_dlc11_qb_def_lokhir_final_battle_pt_04	So, my crew, dispose of this vermin and their god. For riches and murder await!	false
scripted_subtitles_localised_text_wh2_dlc11_sea_shanty_01	Anchor the tides and slow the moons,\\nbreak the waves and tame the sea!	false
scripted_subtitles_localised_text_wh2_dlc11_sea_shanty_02	The monster hunts and the prey will shiver,\\nsince the Vortex went a-quiver!	false
scripted_subtitles_localised_text_wh2_dlc11_sea_shanty_03	The beast cares not if you're living or dead,\\ninto its belly is where you'll head!	false
scripted_subtitles_localised_text_wh2_dlc12_lzd_lordkroak_qb_pt_01	Lord Kroak will be an invaluable ally in the fulfilment of the Great Plan, but his worldly relics are in imminent danger.	false
scripted_subtitles_localised_text_wh2_dlc12_lzd_lordkroak_qb_pt_02_kroqgar	The Skaven approach, Kroq-Gar. Prepare yourself!	false
scripted_subtitles_localised_text_wh2_dlc12_lzd_lordkroak_qb_pt_02_mazdamundi	The Skaven approach, revered master. Prepare yourself!	false
scripted_subtitles_localised_text_wh2_dlc12_lzd_lordkroak_qb_pt_02_tehenhauin	The Skaven approach, mighty Prophet. Prepare yourself!	false
scripted_subtitles_localised_text_wh2_dlc12_lzd_lordkroak_qb_pt_02_tiktaqto	The Skaven approach, Master of Skies. Prepare yourself!	false
scripted_subtitles_localised_text_wh2_dlc12_lzd_lordkroak_qb_pt_03	While Kroak’s forcefield provides him with some protection, the awakening process leaves him vulnerable to attack.	false
scripted_subtitles_localised_text_wh2_dlc12_lzd_lordkroak_qb_pt_04	It is imperative that you defend him until he has fully risen from his slumber!	false
scripted_subtitles_localised_text_wh2_dlc12_lzd_tehenhauin_QB_plaque_of_sotek_pt_01	The time is upon us, apostles! It has been foretold!	false
scripted_subtitles_localised_text_wh2_dlc12_lzd_tehenhauin_QB_plaque_of_sotek_pt_02	The Rodent-God’s pestilent spawn blights our kind, but today the Red Crested Skinks shall strike a vengeful blow.	false
scripted_subtitles_localised_text_wh2_dlc12_lzd_tehenhauin_QB_plaque_of_sotek_pt_03	We shall send these plague-beasts to the bottom of the pit, where the Great Serpent's wrath awaits them!	false
scripted_subtitles_localised_text_wh2_dlc12_lzd_tehenhauin_QB_plaque_of_sotek_pt_04	With this glorious sacrifice, Skaven-kind will know that the Prophecy of Sotek has come to pass!	false
scripted_subtitles_localised_text_wh2_dlc12_lzd_tehenhauin_final_battle_pt_01	Yes, brave apostles! You follow the divine instrument of the Great Serpent!	false
scripted_subtitles_localised_text_wh2_dlc12_lzd_tehenhauin_final_battle_pt_02	Together we have answered our calling to cast the pestilent rat-spawn into oblivion.	false
scripted_subtitles_localised_text_wh2_dlc12_lzd_tehenhauin_final_battle_pt_03	And we must continue to do so, now more than ever!	false
scripted_subtitles_localised_text_wh2_dlc12_lzd_tehenhauin_final_battle_pt_04	For the consummation of the great Skaven manipulation is at hand.	false
scripted_subtitles_localised_text_wh2_dlc12_lzd_tehenhauin_final_battle_pt_05	We shall stop their abhorrent rat-god from entering this realm. The power of Sotek compels us!	false
scripted_subtitles_localised_text_wh2_dlc12_lzd_tiktaqto_QB_mask_of_heavens_pt_01	The Skaven defile those temple ruins, disrupting the Geomantic Web here. 	false
scripted_subtitles_localised_text_wh2_dlc12_lzd_tiktaqto_QB_mask_of_heavens_pt_02	For reasons I cannot see, this disruption also weakens my Mask of Heavens.	false
scripted_subtitles_localised_text_wh2_dlc12_lzd_tiktaqto_QB_mask_of_heavens_pt_03	Our mission is clear. 	false
scripted_subtitles_localised_text_wh2_dlc12_lzd_tiktaqto_QB_mask_of_heavens_pt_04	Purge these plague-beasts from the area, end their contradiction of our master’s will!	false
scripted_subtitles_localised_text_wh2_dlc12_lzd_tiktaqto_QB_mask_of_heavens_pt_05	Braves, bring wrath from the sky!!!	false
scripted_subtitles_localised_text_wh2_dlc12_lzd_tiktaqto_final_battle_pt_01	Those plague-beasts attempt to summon their daemon into this world.	false
scripted_subtitles_localised_text_wh2_dlc12_lzd_tiktaqto_final_battle_pt_02	I sense the Great Plan will be in dire risk.	false
scripted_subtitles_localised_text_wh2_dlc12_lzd_tiktaqto_final_battle_pt_03	It is my sacred duty as Master of Skies to uphold the will of the Old Ones. 	false
scripted_subtitles_localised_text_wh2_dlc12_lzd_tiktaqto_final_battle_pt_04	Braves of the ground and sky, follow and we will finally banish the rat-spawn from this world once and for all!	false
scripted_subtitles_localised_text_wh2_dlc12_skv_ikit_claw_QB_storm_daemon_pt_01	Ikit has the biggest brain of all rats!	false
scripted_subtitles_localised_text_wh2_dlc12_skv_ikit_claw_QB_storm_daemon_pt_02	Hatched a simple-masterful scheme, yes-yes!	false
scripted_subtitles_localised_text_wh2_dlc12_skv_ikit_claw_QB_storm_daemon_pt_03	First - gather the fallen Warpstone, all the Warpstone!	false
scripted_subtitles_localised_text_wh2_dlc12_skv_ikit_claw_QB_storm_daemon_pt_04	Second - make all these stinking reptiles die-die.	false
scripted_subtitles_localised_text_wh2_dlc12_skv_ikit_claw_QB_storm_daemon_pt_05	Murder-death-kill devices at the ready!	false
scripted_subtitles_localised_text_wh2_dlc12_skv_ikit_claw_qb_final_battle_pt_01	Stupid Council-Seers think they can outsmart Chief Warlock Engineer of Skavenblight!	false
scripted_subtitles_localised_text_wh2_dlc12_skv_ikit_claw_qb_final_battle_pt_02	They want to sacrifice Skryre, but I make-make THEM the sacrifice.	false
scripted_subtitles_localised_text_wh2_dlc12_skv_ikit_claw_qb_final_battle_pt_03	Horned Rat will know WE are Skavendom rulers, not stupid Seers. Arm kill-systems!	false
scripted_subtitles_localised_text_wh2_dlc12_skv_ikit_claw_qb_final_battle_pt_04	Yes-good, Elf-things can help us warm up weapons for sacrificing!	false
scripted_subtitles_localised_text_wh2_dlc12_skv_ikit_claw_qb_final_battle_pt_05	All-all-die! My intellect makes Skryre strongest of all clans!	false
scripted_subtitles_localised_text_wh2_dlc13_emp_markus_wulfhart_amber_bow_pt_01	The death of innocent settlers cannot go unanswered, huntsmen!	false
scripted_subtitles_localised_text_wh2_dlc13_emp_markus_wulfhart_amber_bow_pt_02	These unrelenting reptile-monsters must be made to pay, lest they keep coming back.	false
scripted_subtitles_localised_text_wh2_dlc13_emp_markus_wulfhart_amber_bow_pt_03	Make no mistake – these cold-blooded abominations are not just mindless beasts.	false
scripted_subtitles_localised_text_wh2_dlc13_emp_markus_wulfhart_amber_bow_pt_04	They are intelligent… intelligent enough to know the meaning of vengeance.	false
scripted_subtitles_localised_text_wh2_dlc13_emp_markus_wulfhart_amber_bow_pt_05	And now, with our arrows and blades, we will make them feel it.	false
scripted_subtitles_localised_text_wh2_dlc13_emp_markus_wulfhart_final_battle_pt_01	Listen up, huntsmen! Too many good men have fallen to this abominable lizard and its savage attendants. Too many innocent settlers mauled to death and devoured. But no more!	false
scripted_subtitles_localised_text_wh2_dlc13_emp_markus_wulfhart_final_battle_pt_02	The so-called “Spirit of the Jungle” is no ghost. It is a thing of flesh and blood, just like the others of its monstrous kind that we have already seen and slain. It can be killed!	false
scripted_subtitles_localised_text_wh2_dlc13_emp_markus_wulfhart_final_battle_pt_03	I know you are afraid. But remember, fear is not a weakness. It will keep you as sharp as the weapons that you wield. It will keep you alive.	false
scripted_subtitles_localised_text_wh2_dlc13_emp_markus_wulfhart_final_battle_pt_04	Today, civilisation will triumph over the dark wilderness. Man shall triumph over beast!	false
scripted_subtitles_localised_text_wh2_dlc13_lzd_gor_rok_final_battle_pt_01	The masters have brought me here to fulfil my purpose.	false
scripted_subtitles_localised_text_wh2_dlc13_lzd_gor_rok_final_battle_pt_02	Rat-spawn’s Daemon comes now. An abomination to this world and the Great Plan.	false
scripted_subtitles_localised_text_wh2_dlc13_lzd_gor_rok_final_battle_pt_03	I have resisted great foes many times – and today, once again.	false
scripted_subtitles_localised_text_wh2_dlc13_lzd_gor_rok_final_battle_pt_04	Gor-Rok readily takes on more scars to fulfil the will of the Old Ones!	false
scripted_subtitles_localised_text_wh2_dlc13_lzd_gor_rok_shield_of_aeons_pt_01	Lustria’s scourge are at Itza’s gates.	false
scripted_subtitles_localised_text_wh2_dlc13_lzd_gor_rok_shield_of_aeons_pt_02	The dead-spawn filth of the Great Pond seek the Old Ones' treasures.	false
scripted_subtitles_localised_text_wh2_dlc13_lzd_gor_rok_shield_of_aeons_pt_03	The rat-spawn also come. The temple-city must not fall.	false
scripted_subtitles_localised_text_wh2_dlc13_lzd_gor_rok_shield_of_aeons_pt_04	I will fight at the front, without fear. Without pain!	false
scripted_subtitles_localised_text_wh2_dlc13_lzd_nakai_QB_golden_tributes_pt_01	Itza in danger.	false
scripted_subtitles_localised_text_wh2_dlc13_lzd_nakai_QB_golden_tributes_pt_02	Must not fall.	false
scripted_subtitles_localised_text_wh2_dlc13_lzd_nakai_QB_golden_tributes_pt_03	Death to dead-spawn!	false
scripted_subtitles_localised_text_wh2_dlc13_lzd_nakai_QB_ogham_shard_pt_02	Ancient power here.	false
scripted_subtitles_localised_text_wh2_dlc13_lzd_nakai_QB_ogham_shard_pt_03	Nakai feels. Nakai remembers.	false
scripted_subtitles_localised_text_wh2_dlc13_lzd_nakai_QB_ogham_shard_pt_04	Daemon-spawn want artefact.	false
scripted_subtitles_localised_text_wh2_dlc13_lzd_nakai_QB_ogham_shard_pt_05	They will die!	false
scripted_subtitles_localised_text_wh2_dlc13_lzd_nakai_final_battle_pt_02	Warmbloods take lands.	false
scripted_subtitles_localised_text_wh2_dlc13_lzd_nakai_final_battle_pt_03	Warmbloods take artefacts.	false
scripted_subtitles_localised_text_wh2_dlc13_lzd_nakai_final_battle_pt_04	Nakai cannot allow.	false
scripted_subtitles_localised_text_wh2_dlc13_lzd_nakai_final_battle_pt_05	Warmbloods die now!	false
scripted_subtitles_localised_text_wh2_dlc14_Repanse_Sword_of_Lyonesse_pt_01	Warriors of Lyonesse, behold! Even here, the Lady watches over the brave and the righteous. The signs are clear.	false
scripted_subtitles_localised_text_wh2_dlc14_Repanse_Sword_of_Lyonesse_pt_02	Just as in Couronne, when we rode forth to vanquish the evil that threatened to overcome it, we must do so again.	false
scripted_subtitles_localised_text_wh2_dlc14_Repanse_Sword_of_Lyonesse_pt_03	The beleaguered Dwarfs need our help, and now. Like us, they fight against the Undead horrors of this land to rid it of its taint.	false
scripted_subtitles_localised_text_wh2_dlc14_Repanse_Sword_of_Lyonesse_pt_04	The Lady compels us to lend our hands to this noble fight. Chevaliers, Charge!!!	false
scripted_subtitles_localised_text_wh2_dlc14_Repanse_de_Lyonese_final_battle_guardian_pt_01	Hear me, brothers! These foul foes of the ocean seek to ravage our homeland, to plunder it of the riches of our honourable lords.	false
scripted_subtitles_localised_text_wh2_dlc14_Repanse_de_Lyonese_final_battle_guardian_pt_02	I may have been born a peasant, but it has been my life’s purpose to ensure that men of the righteous and good – whether rich or poor – triumph over evil in all forms.	false
scripted_subtitles_localised_text_wh2_dlc14_Repanse_de_Lyonese_final_battle_pt_03	I fear no evil, for I am guided by the Lady's divine will. She watches over me and shows me the way.	false
scripted_subtitles_localised_text_wh2_dlc14_Repanse_de_Lyonese_final_battle_pt_04	Just as my faith in her guides me and gives me strength, have faith in me, and I shall do the same for you.	false
scripted_subtitles_localised_text_wh2_dlc14_Repanse_de_Lyonese_final_battle_pt_05	To battle, Chevaliers!	false
scripted_subtitles_localised_text_wh2_dlc14_Repanse_de_Lyonese_final_battle_vanquisher_pt_01	Hear me, brothers! The foul, Undead kings of these lands want to see the world bow to the dark shroud of their rule. This greatly offends the Lady!	false
scripted_subtitles_localised_text_wh2_dlc14_Repanse_de_Lyonese_final_battle_vanquisher_pt_02	I may have been born a peasant, but it has been my life’s purpose to ensure that men of the righteous and good triumph over evil in all forms.	false
scripted_subtitles_localised_text_wh2_dlc14_Snikch_Cloak_of_Shadows_pt_01	He who steal-takes my things will soon be cut-sliced into giblet-bits, yes-yes! Snikch always gets his mark!	false
scripted_subtitles_localised_text_wh2_dlc14_Snikch_Cloak_of_Shadows_pt_02	Thief cower-hides with his ratling minions, thinks he-he can escape my attentions. No chance!	false
scripted_subtitles_localised_text_wh2_dlc14_Snikch_Cloak_of_Shadows_pt_03	From the-the shadows, I will emerge. Ambush-slay his patrols first, make the thief easier to kill, yes-yes!	false
scripted_subtitles_localised_text_wh2_dlc14_Snikch_final_battle_pt_01	Finally, Nightlord’s mission will be complete, yes-yes. Druchii Elf-thing has what I came for.	false
scripted_subtitles_localised_text_wh2_dlc14_Snikch_final_battle_pt_02	And just in-in time! Long-limb no-fur tries to scurry-escape on his big black paddle-boat, back to Druchii home-nest.	false
scripted_subtitles_localised_text_wh2_dlc14_Snikch_final_battle_pt_03	Aaargh, Naggaroth too far, must finish this here-here and now-now!	false
scripted_subtitles_localised_text_wh2_dlc14_Snikch_final_battle_pt_04	The Daemon-power will be mine, I will cut-slice the Elf-thing open to-to get if I must.	false
scripted_subtitles_localised_text_wh2_dlc14_Snikch_final_battle_pt_05	No-nothing shall stop me, Weeping Blades will make quick work of him! Time to cut-cut and stab-stab!	false
scripted_subtitles_localised_text_wh2_dlc14_emp_Malus_Darkblade_Warpsword_of_Khaine_pt_01	The Chaos Wastes. A brutal and horrific place, but I am no stranger to these twisted lands. My past exploits have brought me to far worse realms.	false
scripted_subtitles_localised_text_wh2_dlc14_emp_Malus_Darkblade_Warpsword_of_Khaine_pt_02	The Warpsword hungers, and must be fed. Something here entices it greatly... Dark energies surge from the blade, more-so than when it tasted the blood of those pathetic, Chaos-crazed Beastmen.	false
scripted_subtitles_localised_text_wh2_dlc14_emp_Malus_Darkblade_Warpsword_of_Khaine_pt_03	Is it me who wields the sword or the sword that wields me? Tz'arkan would surely say it is neither…	false
scripted_subtitles_localised_text_wh2_dlc14_emp_Malus_Darkblade_Warpsword_of_Khaine_pt_04	But I do not depend on you, cursed Daemon! While I am still in control, the blade’s thirst will be sated. It will be empowered once more.	false
scripted_subtitles_localised_text_wh2_dlc14_emp_Malus_Darkblade_Warpsword_of_Khaine_pt_05	By the God of Murder, there is more than enough Chaos blood to spill here, and spill it I will!	false
scripted_subtitles_localised_text_wh2_dlc14_emp_Malus_Darkblade_final_battle_pt_01	Well, well, well… it appears my business here in the Southlands is not over. The rat-maniacs amass in much greater numbers this time. They really don’t want me to leave…	false
scripted_subtitles_localised_text_wh2_dlc14_emp_Malus_Darkblade_final_battle_pt_02	If I could rip you from my soul, Tz’arkan, I would gladly give you up to these beasts! If only things were so simple. My affliction will be dealt with soon anyway – the Witch King promises it.	false
scripted_subtitles_localised_text_wh2_dlc14_emp_Malus_Darkblade_final_battle_pt_03	I need only to get back to Naggaroth with this Black Ark’s cargo of scrolls. But first, I will end this here and now. The verminous menace cannot be allowed to follow me back to the Land of Chill.	false
scripted_subtitles_localised_text_wh2_dlc14_emp_Malus_Darkblade_final_battle_pt_04	The elusive Deathmaster is nearby – let him come. Should he get close, by Khaine’s cup I will cut him down along with the rest of his pathetic brood! 	false
scripted_subtitles_localised_text_wh2_dlc15_GOB_Grom_Axe_of_Grom_pt_01	I’ve ‘ad enough chin waggin’ with this git. He’s been hidin’ out here, braggin’ ‘bout how big he is.	false
scripted_subtitles_localised_text_wh2_dlc15_GOB_Grom_Axe_of_Grom_pt_02	All just rumours, he’s nuffink! Look at his stoopid hat, he’s tryin’ ta make ‘imself look bigger.	false
scripted_subtitles_localised_text_wh2_dlc15_GOB_Grom_Axe_of_Grom_pt_03	He’ll be even shorter once I cut ‘im down ta size 'n’ take back my axe! 	false
scripted_subtitles_localised_text_wh2_dlc15_GOB_Grom_Axe_of_Grom_pt_04	Da ladz been sayin’ dey seen some other gobbos skulkin’ round ‘ere too. Best keep our eyes open!	false
scripted_subtitles_localised_text_wh2_dlc15_GOB_Grom_Axe_of_Grom_pt_05	Guzzler’s gonna get guzzled! There’s only one king of da gobbos, 'n' dat’s ME!	false
scripted_subtitles_localised_text_wh2_dlc15_GOB_Grom_final_battle_pt_01	Time to ‘ave us a right good ruckus! Da Elf-gits are hidin’ behind dem walls, but they won’t hold us back for long.	false
scripted_subtitles_localised_text_wh2_dlc15_GOB_Grom_final_battle_pt_02	We’ll smash ‘em all to crumbly bits, da Doom Diver teamz will see to dat!	false
scripted_subtitles_localised_text_wh2_dlc15_GOB_Grom_final_battle_pt_03	Last time I wos ‘ere, somefink in da tower blocked our magics it did, and I reckon they got some more surprises for us.	false
scripted_subtitles_localised_text_wh2_dlc15_GOB_Grom_final_battle_pt_04	I don’t like da look of dem towers either. So we gots to send in da fodder first, see what da sneaky gits are up to.	false
scripted_subtitles_localised_text_wh2_dlc15_GOB_Grom_final_battle_pt_05	If dat pointy-‘eaded boss shows up, I’ll ‘ave ‘im. This time Grom will show da world he really is da biggest and da strongest!	false
scripted_subtitles_localised_text_wh2_dlc15_HEF_Imrik_Armour_of_Caledor_pt_01	So it IS true! The Blood Dragon dons the lost heirloom of my bloodline. His minions may be many, but when he falls, his control will crumble, along with his shambling minions.	false
scripted_subtitles_localised_text_wh2_dlc15_HEF_Imrik_Armour_of_Caledor_pt_02	The stench of gunpowder and brine is thick in the air, for the fiend brings Undead artillerymen of the sea. Already they have dragged their rickety cannons onto the field. We must be wary of their bombardments.  	false
scripted_subtitles_localised_text_wh2_dlc15_HEF_Imrik_Armour_of_Caledor_pt_03	And… what is this? He has brought some Druchii thralls to battle with him! This Vampire certainly knows how to get my attention. This indignity must be met with all the rage of Caledor!	false
scripted_subtitles_localised_text_wh2_dlc15_HEF_Imrik_Armour_of_Caledor_pt_04	The Vampire wishes to drink the blood of my allies, the mighty Drakes, but he will do no such thing. I shall defeat him and send him and his minions back to their graves!	false
scripted_subtitles_localised_text_wh2_dlc15_HEF_Imrik_final_battle_pt_01	Knight of my great house! Ulthuan needs us now more than ever, for we are the absolute of its warriors.	false
scripted_subtitles_localised_text_wh2_dlc15_HEF_Imrik_final_battle_pt_02	The Vortex is the legacy of my bloodline. Somewhere beneath the swirling maelstrom, the great Caledor Dragontamer eternally stands in conjuration, protecting us still.	false
scripted_subtitles_localised_text_wh2_dlc15_HEF_Imrik_final_battle_pt_03	The summoning of the Skaven’s verminous god threatens everything he sacrificed himself for.	false
scripted_subtitles_localised_text_wh2_dlc15_HEF_Imrik_final_battle_pt_04	This cataclysm cannot come to pass, brothers. It is time for Caledor to rise once again!	false
scripted_subtitles_localised_text_wh2_dlc15_hef_Eltharion_Talisman_of_Hoeth_pt_01	Hark, Kinsmen! It is now clear that the weakening of the Talisman was not without reason. The medallion’s connection to the ancient Waystones has revealed a dire fate.	false
scripted_subtitles_localised_text_wh2_dlc15_hef_Eltharion_Talisman_of_Hoeth_pt_02	This Ruinous host of Chaos seeks to destroy this Waystone, and all others that protect Ulthuan. Our proximity to it shall grant us its power, but it also nourishes our foes.	false
scripted_subtitles_localised_text_wh2_dlc15_hef_Eltharion_Talisman_of_Hoeth_pt_03	The Keepers of the Stones send aid from the mountain pass to the north, but the river will not slow these twisted beings for long. We must hold this position to the last.	false
scripted_subtitles_localised_text_wh2_dlc15_hef_Eltharion_Talisman_of_Hoeth_pt_04	If we fail, Yvresse will fall, and all Ulthuan will be next. The fate of the vortex – nay, the entire world – rests on our shoulders.	false
scripted_subtitles_localised_text_wh2_dlc15_hef_Eltharion_final_battle_pt_01	I’ve always known this day would come. Grom the Fat’s appetite for destruction knows no bounds and he has led his foul horde back to the gates of our city once more.	false
scripted_subtitles_localised_text_wh2_dlc15_hef_Eltharion_final_battle_pt_02	Hold the walls as long as you can my warriors, but if absolutely necessary we shall fall back and make a last stand in front of the tower.	false
scripted_subtitles_localised_text_wh2_dlc15_hef_Eltharion_final_battle_pt_03	Above all, the Waystone must not fall, for its destruction will be the catalyst for all Ulthuan’s doom.	false
scripted_subtitles_localised_text_wh2_dlc15_hef_Eltharion_final_battle_pt_04	Remember, if the walls are breached, we must retreat through the main gangways. By Lileath’s will, their mobs shall follow us right into the enchanted traps set by our Mages. May the power of Mathlaan and Azyr strike them down.	false
scripted_subtitles_localised_text_wh2_dlc15_hef_Eltharion_final_battle_pt_05	Grom will not stop until Tor Yvresse is left in flames and rubble. But I have defeated his horde before, and will do so again. This time, he will have no escape – I will make sure of it.	false
scripted_subtitles_localised_text_wh2_dlc16_Drycha_Coeddil_Unchained_IGC01_01	Ahh yes! Forest Spirits, come!	false
scripted_subtitles_localised_text_wh2_dlc16_Drycha_Coeddil_Unchained_IGC01_02	Soon the enemy will taste the vengeance of our fallen sisters!	false
scripted_subtitles_localised_text_wh2_dlc16_Drycha_Coeddil_Unchained_IGC02_01	Aid me Forest Spirits! I speak for the Tree of Woe!	false
scripted_subtitles_localised_text_wh2_dlc16_Drycha_Coeddil_Unchained_IGC02_02	We are strong! Let us rend the enemy asunder!	false
scripted_subtitles_localised_text_wh2_dlc16_Drycha_Coeddil_Unchained_IGC03_01	Coeddil comes! Our vengeance now awaits!	false
scripted_subtitles_localised_text_wh2_dlc16_Drycha_Coeddil_Unchained_IGC03_02	We shall show them that we are the true keepers of the forest! All will suffer our...	false
scripted_subtitles_localised_text_wh2_dlc16_Drycha_Coeddil_Unchained_IGC03_03	Ancient!	false
scripted_subtitles_localised_text_wh2_dlc16_Drycha_Coeddil_Unchained_IGC03_04	Vengeful!	false
scripted_subtitles_localised_text_wh2_dlc16_Drycha_Coeddil_Unchained_IGC03_05	Wrath!	false
scripted_subtitles_localised_text_wh2_dlc16_Drycha_Coeddil_Unchained_pt_01	I am here, Coeddil! The time has come. Your freedom is at hand.	false
scripted_subtitles_localised_text_wh2_dlc16_Drycha_Coeddil_Unchained_pt_02	The Wildwood Rangers approach. The foolish saplings dare to try and stop us.	false
scripted_subtitles_localised_text_wh2_dlc16_Drycha_Coeddil_Unchained_pt_03	In the hallowed name of every Tree Spirit that has fallen due to Asrai negligence, the dirt shall be fertilised with Elven blood this day – I will make sure of it.	false
scripted_subtitles_localised_text_wh2_dlc16_Drycha_Coeddil_Unchained_pt_04	We shall show them that we are the true keepers of the forest, not them!	false
scripted_subtitles_localised_text_wh2_dlc16_Drycha_final_battle_Sisters_pt_01	Chaos! Forest spirits forgive me, I did not know!	false
scripted_subtitles_localised_text_wh2_dlc16_Drycha_final_battle_Sisters_pt_02	Then for the sake of all my kin, I must ally with you who stole the woods from us.	false
scripted_subtitles_localised_text_wh2_dlc16_Drycha_final_battle_Sisters_pt_03	But do not think this dims my wrath, Elves! Your poison queen's time will yet come…	false
scripted_subtitles_localised_text_wh2_dlc16_Drycha_final_battle_Thrott_pt_01	No! That… that is a portal to the Dreaming Wood! How could I have been so blind?	false
scripted_subtitles_localised_text_wh2_dlc16_Drycha_final_battle_Thrott_pt_02	If the vile Ariel cannot seal it, the Daemons of Chaos will raze my forest!	false
scripted_subtitles_localised_text_wh2_dlc16_Drycha_final_battle_Thrott_pt_03	Coeddil forgive me, but for the sake of all Loren, I must ally myself with the hated Elves. 	false
scripted_subtitles_localised_text_wh2_dlc16_Sisters_Ceithin_Har_pt_01	Where's my Dragon, Cloven Ones!?	false
scripted_subtitles_localised_text_wh2_dlc16_Sisters_Ceithin_Har_pt_02	Patience, Arahan. Behold, the horned shaman perform some dark rite with their obscene stones. I know not the intent of these servants of Chaos, but it surely bodes ill.	false
scripted_subtitles_localised_text_wh2_dlc16_Sisters_Ceithin_Har_pt_03	More pointless busywork, Naestra? How typically tedious of you. Well, at least I get to slaughter a few Beastmen.	false
scripted_subtitles_localised_text_wh2_dlc16_Sisters_Ceithin_Har_pt_04	I sense a far greater reward than indulging your childish bloodthirst, sister. Ceithin-Har is near, but... bound, and in shadow. If we can stop this fell ritual, perhaps our winged friend shall at last be revealed to us?	false
scripted_subtitles_localised_text_wh2_dlc16_Sisters_Ceithin_Har_pt_05	I thought I smelled something else, too. In the trees... No, it's... probably nothing. Let's go get our Dragon back.	false
scripted_subtitles_localised_text_wh2_dlc16_Sisters_Ceithin_Har_pt_06	For the forest!	false
scripted_subtitles_localised_text_wh2_dlc16_Sisters_Final_Battle_pt_01	Our queen is in place. The sealing rite begins. Chaos shall not breach this realm! 	false
scripted_subtitles_localised_text_wh2_dlc16_Sisters_Final_Battle_pt_02	I'm bored already, Naestra. What else can we kill? 	false
scripted_subtitles_localised_text_wh2_dlc16_Sisters_Final_Battle_pt_03	There is no shortage of vermin with which to slake your tiresome thirst for carnage, sister.	false
scripted_subtitles_localised_text_wh2_dlc16_Sisters_Final_Battle_pt_04	Their leader is hideous, even for a rat. And so big! This hunt shall be glorious!	false
scripted_subtitles_localised_text_wh2_dlc16_Sisters_Final_Battle_pt_05	Think not of glory, Arahan. Should that warp-maddened brute prevent the Mage-Queen from completing her ritual, doom absolute shall follow.	false
scripted_subtitles_localised_text_wh2_dlc16_Sisters_Final_Battle_pt_06	Have no fear, dear Naestra. I have arrows enough for all its mutant limbs, and all its chittering kin. No more rats, and no more Chaos. Oh, this will be fun!	false
scripted_subtitles_localised_text_wh2_dlc16_Sisters_Final_Battle_pt_07	Then to battle, sister! 	false
scripted_subtitles_localised_text_wh2_dlc16_Sisters_Final_Battle_pt_08	For the Queen in the Woods! For all Athel Loren!	false
scripted_subtitles_localised_text_wh2_dlc16_Sisters_Final_Battle_pt_09	You!	false
scripted_subtitles_localised_text_wh2_dlc16_Sisters_Final_Battle_pt_10	Sold out by a tree. No wonder the rats knew our every move.	false
scripted_subtitles_localised_text_wh2_dlc16_Sisters_Final_Battle_pt_11	Your foolhardy hate blinds you to the true threat, Drycha. Great Ariel's spell is all that safeguards our forest - your forest - from the monstrosities of Chaos.	false
scripted_subtitles_localised_text_wh2_dlc16_Sisters_Final_Battle_pt_12	In other words, if the queen dies, we all die. Time to pick a side, Dryad.	false
scripted_subtitles_localised_text_wh2_dlc16_Throt_Whip_of_Domination_pt_01	Fool-fool Chaos-things attack Hell Pit again! Why they not learn lesson last time-time? 	false
scripted_subtitles_localised_text_wh2_dlc16_Throt_Whip_of_Domination_pt_02	Big problem, yes? Hell Pit not send abomination-monsters to other clan-clans til spiky-things gone-gone!	false
scripted_subtitles_localised_text_wh2_dlc16_Throt_Whip_of_Domination_pt_03	Why Ghoritch-thing not stop-kill Chaos-things yet? Fool-fool Rat-Ogre! Stupid man-thing brain make it weak-frail!	false
scripted_subtitles_localised_text_wh2_dlc16_Throt_Whip_of_Domination_pt_04	Bah! Me must do all thing-things, make nasty spiky-things die-die quick-fast, or other clans be mad-mad. Keeps me from lab-lab! And me so hungry... HUNGRY! 	false
scripted_subtitles_localised_text_wh2_dlc16_Throt_Whip_of_Domination_pt_05	Maybe me eat Ghoritch-thing once Chaos-things dead-dead. Or maybe... me put Ghoritch-thing brain into Plague Toad, hee-hee-hee-hoo-hah-hah-hah!	false
scripted_subtitles_localised_text_wh2_dlc16_Throt_final_battle_pt_01	Ha! There Elf queen-thing! At last-last! She cast great spell-spell, just as strange tree-thing said-told. 	false
scripted_subtitles_localised_text_wh2_dlc16_Throt_final_battle_pt_02	She busy-occupied – so can take-steal, eat magic pulp-flesh! Me finally cure the HUNGER! Hah-hah-ha-hee!	false
scripted_subtitles_localised_text_wh2_dlc16_Throt_final_battle_pt_03	First, other nasty Elf-things must die-die. Me eat best bits, yes-yes? Experiments, ratkin, set-ready! Fight for Moulder clan! Fight for THROT! 	false
scripted_subtitles_localised_text_wh2_dlc16_Throt_final_battle_pt_04	Fail and me eat arms and leg-legs! Stitch-sew heads onto socket-holes! Put brains in worm-things! 	false
scripted_subtitles_localised_text_wh2_dlc16_Throt_final_battle_pt_05	You not fail-lose! Go-go! Ah-hah-hah-hah-ha! ....Me so hungry....	false
scripted_subtitles_localised_text_wh2_dlc16_Throt_final_battle_pt_06	Tree-thing fool-fool! Not betray Throt! Me care not what nasty Chaos-things do to forest-wood. 	false
scripted_subtitles_localised_text_wh2_dlc16_Throt_final_battle_pt_07	Only want Elf queen-thing! Tree-thing burn-burn too! Hah-hah-hah-hee!	false
scripted_subtitles_localised_text_wh2_dlc16_Throt_final_battle_pt_08	Floaty bug-thing dead-dead! So much for fool-fool demi-god! Hee-hah-hah-ha! Quick-fast, bring Elf-thing body to me. NOW-NOW!	false
scripted_subtitles_localised_text_wh2_dlc16_Throt_final_battle_pt_09	Yes-yes! We have queen-bug-thing! Now will feast-devour, finally be free-free! First, must scuttle-scurry away. Very-very bad things coming…	false
scripted_subtitles_localised_text_wh2_dlc17_bst_taurox_final_battle_phase_2a	Morghur weak! Leader of nothing. Me strongest!	false
scripted_subtitles_localised_text_wh2_dlc17_bst_taurox_final_battle_phase_2b	Morghur's brayherd obeys Taurox now! Release prisoners! Begin sacrifices!	false
scripted_subtitles_localised_text_wh2_dlc17_bst_taurox_final_battle_phase_3a	Many sacrifices made. Dark Masters are pleased!	false
scripted_subtitles_localised_text_wh2_dlc17_bst_taurox_final_battle_phase_3b	Hated Coldskins stalk Taurox. Now they die too.	false
scripted_subtitles_localised_text_wh2_dlc17_bst_taurox_final_battle_phase_3c	The hiding coward is here... Good! All will be sacrifices. More favour for Taurox!	false
scripted_subtitles_localised_text_wh2_dlc17_bst_taurox_final_battle_pt_01	At last! The Heart of the Dark. The Great Herdstone belong to Taurox! Wait… What?	false
scripted_subtitles_localised_text_wh2_dlc17_bst_taurox_final_battle_pt_02	Morghur! By the Dark Gods… Taurox is chosen! Taurox is Strongest! Grrrgh!	false
scripted_subtitles_localised_text_wh2_dlc17_bst_taurox_final_battle_pt_03	Morghur already bring offerings to the Herdstone… Taurox take them! Taurox make sacrifice for Dark Masters! Hurr!	false
scripted_subtitles_localised_text_wh2_dlc17_bst_taurox_final_battle_pt_04	Daemons flock to Heart of the Dark. They come for Taurox’s offering, not Morghur’s! Taurox must appease Dark Masters…	false
scripted_subtitles_localised_text_wh2_dlc17_bst_taurox_final_battle_pt_05	I challenge! If Morghur not surrender, Taurox crush him! Feel Bloodgreed! To War!	false
scripted_subtitles_localised_text_wh2_dlc17_bst_taurox_rune_tortured_axes_pt_01	Dark Masters grant Taurox vision of great victory! This Taurox destiny, here and now. We slaughter the Dark Elves, for Chaos!	false
scripted_subtitles_localised_text_wh2_dlc17_bst_taurox_rune_tortured_axes_pt_02	They come from behind their walls. They come to meet the Bloodbeast in battle… The Dark Elves want blood, Taurox give them blood!	false
scripted_subtitles_localised_text_wh2_dlc17_bst_taurox_rune_tortured_axes_pt_03	We meet the Elves at river crossing. We pile their puny bodies high. We slaughter them for Dark Masters, and the river run red with their blood!	false
scripted_subtitles_localised_text_wh2_dlc17_dwf_thorek_ironbrow_final_battle_pt_01	At long last, the lost treasures of our Ancestors are within reach! So long have I dreamed of this day!	false
scripted_subtitles_localised_text_wh2_dlc17_dwf_thorek_ironbrow_final_battle_pt_02	To think of all we've endured here, so far from home. And now brothers, our reward is finally at hand!	false
scripted_subtitles_localised_text_wh2_dlc17_dwf_thorek_ironbrow_final_battle_pt_03	What? No! Wretched vermin! How dare they sully this place with their vile presence!	false
scripted_subtitles_localised_text_wh2_dlc17_dwf_thorek_ironbrow_final_battle_pt_04	Warriors at the ready! Destroy every last trace of this Raki pestilence — we can't let them breach the vault!	false
scripted_subtitles_localised_text_wh2_dlc17_dwf_thorek_ironbrow_final_battle_pt_05	These repulsive creatures defile our very history! For that, they will pay in blood!	false
scripted_subtitles_localised_text_wh2_dlc17_dwf_thorek_ironbrow_final_battle_pt_06	Blasted Raki Vermintide, they just don't know when they're beaten!	false
scripted_subtitles_localised_text_wh2_dlc17_dwf_thorek_ironbrow_final_battle_pt_07	Hold the pass brothers, and give no quarter! The might of the Dawi will not be broken this day!	false
scripted_subtitles_localised_text_wh2_dlc17_dwf_thorek_ironbrow_final_battle_pt_08	It's time to bring the wrath of Grimnir down upon them, and cleanse this infestation once and for all!	false
scripted_subtitles_localised_text_wh2_dlc17_dwf_thorek_ironbrow_klad_brakak_pt_01	To arms, fellow Dawi! This insolent lout thinks to steal our quarry out from under us!	false
scripted_subtitles_localised_text_wh2_dlc17_dwf_thorek_ironbrow_klad_brakak_pt_02	Blinded by youth and ignorance! Your worthless new technologies spit in the face of the Ancestors, Jorek!	false
scripted_subtitles_localised_text_wh2_dlc17_dwf_thorek_ironbrow_klad_brakak_pt_03	Clearly the Trouser Legs Ritual you suffered all those years ago did not put you in your place. Now I must be the one to do so!	false
scripted_subtitles_localised_text_wh2_dlc17_dwf_thorek_ironbrow_klad_brakak_pt_04	The beast is ours! No man, creature or Dawi will stand in our way!	false
scripted_subtitles_localised_text_wh2_dlc17_dwf_thorek_ironbrow_klad_brakak_pt_05	To glory, hazkals! Let's claim one more victory for the old ways!	false
scripted_subtitles_localised_text_wh2_dlc17_lzd_oxyotl_final_battle_phase_1_pt_01	We have bided our time long enough. The purpose of this fell place is clear, the time for action is now.	false
scripted_subtitles_localised_text_wh2_dlc17_lzd_oxyotl_final_battle_phase_1_pt_02	Behold, the one known as Taurox brings vast numbers of other Children of Chaos, beckoned by the dark power of that stone.	false
scripted_subtitles_localised_text_wh2_dlc17_lzd_oxyotl_final_battle_phase_1_pt_03	His sacrificial rites are a critical step for Chaos’ advancement into the world, but freeing his captives will slow his progress.	false
scripted_subtitles_localised_text_wh2_dlc17_lzd_oxyotl_final_battle_phase_1_pt_04	We have the upper hand – for now – but this Doombull must be struck down before he musters more cohorts.	false
scripted_subtitles_localised_text_wh2_dlc17_lzd_oxyotl_final_battle_phase_1_pt_05	Ready yourselves, braves. The Children of Chaos are the sworn enemies of the Old Ones, and the entire world. They must not prevail!	false
scripted_subtitles_localised_text_wh2_dlc17_lzd_oxyotl_final_battle_phase_2a	The Cloven Ones no longer have reinforcements! Their forces flee!	false
scripted_subtitles_localised_text_wh2_dlc17_lzd_oxyotl_final_battle_phase_2b	The Dark Gods must be deprived of their sacrificial offerings. If we kill the Great Bray-Shaman overseers, the prisoners shall go free.	false
scripted_subtitles_localised_text_wh2_dlc17_lzd_oxyotl_final_battle_phase_3a	Our allies join the fight. Advance, braves! Advance!	false
scripted_subtitles_localised_text_wh2_dlc17_lzd_oxyotl_final_battle_phase_3b	The captives bolster our numbers!	false
scripted_subtitles_localised_text_wh2_dlc17_lzd_oxyotl_final_battle_phase_3c	The warmbloods fight as allies. Chaos truly is a bane to all.	false
scripted_subtitles_localised_text_wh2_dlc17_lzd_oxyotl_final_battle_phase_3d	This will not end until the Bloodbeast is slain! We must send him to oblivion where all Chaos belongs! 	false
scripted_subtitles_localised_text_wh2_dlc17_lzd_oxyotl_the_golden_blowpipe_of_ptoohee_pt_01	I have seen the horror of the Ruinous Powers. Wherever their influence spreads in this world, death surely follows.	false
scripted_subtitles_localised_text_wh2_dlc17_lzd_oxyotl_the_golden_blowpipe_of_ptoohee_pt_02	A mere trinket is all Chaos needs to strengthen its grip over the younger races.	false
scripted_subtitles_localised_text_wh2_dlc17_lzd_oxyotl_the_golden_blowpipe_of_ptoohee_pt_03	Ready yourselves, braves! The untamed ones approach, expecting to secure more fell artefacts. 	false
scripted_subtitles_localised_text_wh2_dlc17_lzd_oxyotl_the_golden_blowpipe_of_ptoohee_pt_04a	The traders of Naggaroth are also near – let them come. They too will meet their end.	false
scripted_subtitles_localised_text_wh2_dlc17_lzd_oxyotl_the_golden_blowpipe_of_ptoohee_pt_04b	Their colluders dare not come, already punished for their crimes. The warmbloods shall face us alone.	false
scripted_subtitles_localised_text_wh2_intro_battle_def_1	Vermin dare infest my capital? Skavenblight over-exerts itself.	false
scripted_subtitles_localised_text_wh2_intro_battle_def_2	I will not tolerate pests in Naggarond. The vermin will learn that my city, my realm, is a cold, cruel place.	false
scripted_subtitles_localised_text_wh2_intro_battle_def_3	Purge the city, my warriors, but ensure you leave some alive - I wish to know how loud a rat can scream.	false
scripted_subtitles_localised_text_wh2_intro_battle_hef_1	Fellow Asur, hear my words! Yet again the Druchii come at us - a never-ending a tide of war.	false
scripted_subtitles_localised_text_wh2_intro_battle_hef_2	But Ulthuan’s cliffs are strong! Its shores refuse to be washed away by the waves of our hated kin.	false
scripted_subtitles_localised_text_wh2_intro_battle_hef_3	Today we must guard Lothern’s sea walls – let the Druchii torrent come!	false
scripted_subtitles_localised_text_wh2_intro_battle_hef_4	Their waves will break upon us! Turn back the flood! For Ulthuan, for the Phoenix King, for Asuryan!	false
scripted_subtitles_localised_text_wh2_intro_battle_lzd_1	These warmbloods are aligned with the ancient enemy. They must be destroyed.	false
scripted_subtitles_localised_text_wh2_intro_battle_lzd_2	When the threat is eradicated I may contemplate the greater peril.	false
scripted_subtitles_localised_text_wh2_intro_battle_lzd_3	Begin the purge!	false
scripted_subtitles_localised_text_wh2_intro_battle_skv_1	Why-why Gnawdwell, send Queek down to this backwater? To make fool of Queek, yes-yes?!	false
scripted_subtitles_localised_text_wh2_intro_battle_skv_2	I not fail here – I make Clan Mors great in south, make Clanrats chirp my name! Make lands mine-mine!	false
scripted_subtitles_localised_text_wh2_intro_battle_skv_3	Start by killing Elf-things! I want them dead-dead!	false
scripted_subtitles_localised_text_wh2_intro_battle_skv_4	Go-go! Kill! Do not fail me-me!	false
scripted_subtitles_localised_text_wh2_main_great_vortex_liz_kroq_gar_hand_of_gods_stage_3_pt_01	The warmbloods trespass...	false
scripted_subtitles_localised_text_wh2_main_great_vortex_liz_kroq_gar_hand_of_gods_stage_3_pt_02	Fallen Gates not for them.	false
scripted_subtitles_localised_text_wh2_main_great_vortex_liz_kroq_gar_hand_of_gods_stage_3_pt_03	Their magic-users dare to activate the stellar engine at centre... Ignorance!	false
scripted_subtitles_localised_text_wh2_main_great_vortex_liz_kroq_gar_hand_of_gods_stage_3_pt_04	Forwards - cross the bridge! I must see trespassers punished!   	false
scripted_subtitles_localised_text_wh2_main_great_vortex_liz_kroq_gar_hand_of_gods_stage_3_pt_05	Attack now! Destroy and rend, so declares Lord of Solar-City!	false
scripted_subtitles_localised_text_wh2_main_qb_def_malekith_circlet_of_iron_stage_3_altar_of_ultimate_darkness_pt_01	These Chaos dredges bore me. At least with the Asur I can enjoy their death screams. Yet it is a labour that must be undertaken.	false
scripted_subtitles_localised_text_wh2_main_qb_def_malekith_circlet_of_iron_stage_3_altar_of_ultimate_darkness_pt_02	I claim this altar, not in Khaine’s name, but mine own.	false
scripted_subtitles_localised_text_wh2_main_qb_def_malekith_circlet_of_iron_stage_3_altar_of_ultimate_darkness_pt_03	Savants of the desperate Gods, I advise you stay out of my way,	false
scripted_subtitles_localised_text_wh2_main_qb_def_malekith_circlet_of_iron_stage_3_altar_of_ultimate_darkness_pt_04	If not, you shall face the might of the Druchii, and our ways of killing are far more inventive than your own!	false
scripted_subtitles_localised_text_wh2_main_qb_def_malekith_destroyer_stage_3_vauls_anvil_pt_01	Fools! Herds of Asur clog the path to Vaul’s petty shrine. Sweep them aside, my kin!	false
scripted_subtitles_localised_text_wh2_main_qb_def_malekith_destroyer_stage_3_vauls_anvil_pt_02	Let the king approach the god and have the god kneel!	false
scripted_subtitles_localised_text_wh2_main_qb_def_malekith_destroyer_stage_3_vauls_anvil_pt_03	Send forth the vanguard - have them prepare my way.	false
scripted_subtitles_localised_text_wh2_main_qb_def_malekith_destroyer_stage_3_vauls_anvil_pt_04	Vaul will deign to bless my sword; he will marvel at my creation - or I will destroy all of his!	false
scripted_subtitles_localised_text_wh2_main_qb_def_malekith_supreme_spellshield_stage_3_mosquito_swamps_pt_01	Those that thought to slay me, know that I hold no grudge, for betrayal is part of our way.	false
scripted_subtitles_localised_text_wh2_main_qb_def_malekith_supreme_spellshield_stage_3_mosquito_swamps_pt_02	But now… now I expect you to die for me.	false
scripted_subtitles_localised_text_wh2_main_qb_def_malekith_supreme_spellshield_stage_3_mosquito_swamps_pt_03	The reptiles will seek to snare us. But we are the hunters - the trap is mine to spring - ensure it is executed.    	false
scripted_subtitles_localised_text_wh2_main_qb_def_malekith_supreme_spellshield_stage_3_mosquito_swamps_pt_04	Begin the attack, return to me my Spellshield - ensure we are the hunters, not the prey!	false
scripted_subtitles_localised_text_wh2_main_qb_def_morathi_heartrender_and_the_darksword_stage_6_arnheim_pt_01	My son will learn that I am not a doll that can be cast aside when he tires of me!	false
scripted_subtitles_localised_text_wh2_main_qb_def_morathi_heartrender_and_the_darksword_stage_6_arnheim_pt_02	I shall take this sanctuary and from the souls within compose a song of screams and torment!	false
scripted_subtitles_localised_text_wh2_main_qb_def_morathi_heartrender_and_the_darksword_stage_6_arnheim_pt_03	Let them come to the shore, sally from their pristine walls, so I can smear them in Asur blood!   	false
scripted_subtitles_localised_text_wh2_main_qb_def_morathi_heartrender_and_the_darksword_stage_6_arnheim_pt_04	Bring me this colony, sisters, kill many - but make sure half are taken alive!	false
scripted_subtitles_localised_text_wh2_main_qb_hef_teclis_sword_of_teclis_stage_vauls_anvil_3_pt_01	I see the Witch King’s armies, but not Malekith himself!	false
scripted_subtitles_localised_text_wh2_main_qb_hef_teclis_sword_of_teclis_stage_vauls_anvil_3_pt_02	They say he is scared of me - that he worries about a prophecy that foretells his doom by a magic-wielder of male aspect.	false
scripted_subtitles_localised_text_wh2_main_qb_hef_teclis_sword_of_teclis_stage_vauls_anvil_3_pt_03	Perhaps he cowers on his Black Ark?	false
scripted_subtitles_localised_text_wh2_main_qb_hef_teclis_sword_of_teclis_stage_vauls_anvil_3_pt_04	Do not show these fallen-kin mercy for they have never shown us any…	false
scripted_subtitles_localised_text_wh2_main_qb_hef_teclis_sword_of_teclis_stage_vauls_anvil_3_pt_05	For Lileath, for the Phoenix Throne, for Ulthuan!	false
scripted_subtitles_localised_text_wh2_main_qb_hef_teclis_war_crown_of_saphery_stage_3_caverns_of_the_great_bat_pt_01	Steel yourselves, my kin, for now we fight not just to reclaim the War Crown for the honour of Saphery, but to vanquish the children of the Horned God.	false
scripted_subtitles_localised_text_wh2_main_qb_hef_teclis_war_crown_of_saphery_stage_3_caverns_of_the_great_bat_pt_02	They will come at us mercilessly, but know that every Skaven is a coward.	false
scripted_subtitles_localised_text_wh2_main_qb_hef_teclis_war_crown_of_saphery_stage_3_caverns_of_the_great_bat_pt_03	They are only emboldened in numbers, and so we must cut them down. The creatures that remain will become ever more craven! 	false
scripted_subtitles_localised_text_wh2_main_qb_hef_teclis_war_crown_of_saphery_stage_3_caverns_of_the_great_bat_pt_04	Let me deal with the Bat, it has slain two creatures of Ulthuan and they must be avenged!	false
scripted_subtitles_localised_text_wh2_main_qb_hef_tyrion_dragon_armour_of_aenarion_stage_4_vauls_anvil_pt_01	Elves of Ulthuan to me! The scum of Naggaroth approach.	false
scripted_subtitles_localised_text_wh2_main_qb_hef_tyrion_dragon_armour_of_aenarion_stage_4_vauls_anvil_pt_02	They think to cage us in… but is the lion trapped when cornered by the rat? Do warriors squirm when confronted by weaklings?	false
scripted_subtitles_localised_text_wh2_main_qb_hef_tyrion_dragon_armour_of_aenarion_stage_4_vauls_anvil_pt_03	No is the answer!	false
scripted_subtitles_localised_text_wh2_main_qb_hef_tyrion_dragon_armour_of_aenarion_stage_4_vauls_anvil_pt_04	Gird your souls, let them come!	false
scripted_subtitles_localised_text_wh2_main_qb_hef_tyrion_sunfang_stage_4_tower_of_hoeth_pt_01	This is a sad day for Ulthuan, when Asur fights Asur within sight of the White Tower.	false
scripted_subtitles_localised_text_wh2_main_qb_hef_tyrion_sunfang_stage_4_tower_of_hoeth_pt_02	Bel-Korhadris would surely weep, as I will for the dead that I slay this day.	false
scripted_subtitles_localised_text_wh2_main_qb_hef_tyrion_sunfang_stage_4_tower_of_hoeth_pt_03	But make no mistake, I will reap a toll, for my honour has been called into question.	false
scripted_subtitles_localised_text_wh2_main_qb_hef_tyrion_sunfang_stage_4_tower_of_hoeth_pt_04	The offence must be sated - and only then shall I take up Sunfang to fight the true enemies of the Phoenix Throne! 	false
scripted_subtitles_localised_text_wh2_main_qb_lzd_kroqgar_revered_spear_of_tlanxla_stage_3_mosquito_swamps_pt_01	Purge this swamp.	false
scripted_subtitles_localised_text_wh2_main_qb_lzd_kroqgar_revered_spear_of_tlanxla_stage_3_mosquito_swamps_pt_02	Drain it of filth, of the warm-blood’s presence.	false
scripted_subtitles_localised_text_wh2_main_qb_lzd_kroqgar_revered_spear_of_tlanxla_stage_3_mosquito_swamps_pt_03	The way must be purged, so I can approach the revered Old One.	false
scripted_subtitles_localised_text_wh2_main_qb_lzd_kroqgar_revered_spear_of_tlanxla_stage_3_mosquito_swamps_pt_04	Do this quickly, time marches against us!	false
scripted_subtitles_localised_text_wh2_main_qb_lzd_mazdamundi_cobra_mace_of_mazdamundi_stage_3_isle_of_the_crimson_skull_pt_01	I will bring ruination to these warm-blooded Rat-abominations!	false
scripted_subtitles_localised_text_wh2_main_qb_lzd_mazdamundi_cobra_mace_of_mazdamundi_stage_3_isle_of_the_crimson_skull_pt_02	They were never part of the Old Ones’ plan - an accident of the cosmos - that must be rectified.	false
scripted_subtitles_localised_text_wh2_main_qb_lzd_mazdamundi_cobra_mace_of_mazdamundi_stage_3_isle_of_the_crimson_skull_pt_03	All need to be annihilated in time, but first start with these Vermin-spawn!	false
scripted_subtitles_localised_text_wh2_main_qb_lzd_mazdamundi_sunburst_standard_of_hexoatl_stage_4_fallen_gates_pt_01	Prepare to defend the Gate, it must not fall into the clutches of the enemy.	false
scripted_subtitles_localised_text_wh2_main_qb_lzd_mazdamundi_sunburst_standard_of_hexoatl_stage_4_fallen_gates_pt_02	Your lives are nothing compared to this objective. Enforce my will - but do not sell your essence short.	false
scripted_subtitles_localised_text_wh2_main_qb_lzd_mazdamundi_sunburst_standard_of_hexoatl_stage_4_fallen_gates_pt_03	If you must die, then take as many of the enemy’s servants with you.	false
scripted_subtitles_localised_text_wh2_main_qb_lzd_mazdamundi_sunburst_standard_of_hexoatl_stage_4_fallen_gates_pt_04	I have spoken, that is my will - see it is done.	false
scripted_subtitles_localised_text_wh2_main_qb_skv_queek_headtaker_dwarfgouger_stage_4_gouger_gully_pt_01	Dwarf-things! Look how they scurry to us on such little legs! Racing to fight-fight!	false
scripted_subtitles_localised_text_wh2_main_qb_skv_queek_headtaker_dwarfgouger_stage_4_gouger_gully_pt_02	We will give them battle, yes-yes! I’ll take back Gouger, and collect many beards this day-day!	false
scripted_subtitles_localised_text_wh2_main_qb_skv_queek_headtaker_dwarfgouger_stage_4_gouger_gully_pt_03	No other rat must slay more than me-me. Any who attempt to out-kill me-me will pay!	false
scripted_subtitles_localised_text_wh2_main_qb_skv_queek_headtaker_dwarfgouger_stage_4_gouger_gully_pt_04	Get them! Get them now-now!	false
scripted_subtitles_localised_text_wh2_main_qb_skv_queek_headtaker_warp_shard_armour_stage_6_warp_shard_caverns_pt_01	Says his armour is more special than mine does he-he! Then I will take-steal it! I am Queek! The best stuff shall be mine. 	false
scripted_subtitles_localised_text_wh2_main_qb_skv_queek_headtaker_warp_shard_armour_stage_6_warp_shard_caverns_pt_02	But cunning is this vermin, yes-yes. I will have to be wary. Make sure Clanrats set off the traps - better they die than me-me!	false
scripted_subtitles_localised_text_wh2_main_qb_skv_queek_headtaker_warp_shard_armour_stage_6_warp_shard_caverns_pt_03	Scurry-forward now-now, begin-fight! Kill-kill!  	false
scripted_subtitles_localised_text_wh2_main_qb_skv_skrolk_rod_of_corruption_stage_3_isle_of_the_crimson_skull_pt_01	Such a paradise! Unblemished. Pure. It must be gifted the touch-touch of Pestilens!	false
scripted_subtitles_localised_text_wh2_main_qb_skv_skrolk_rod_of_corruption_stage_3_isle_of_the_crimson_skull_pt_02	That the Reptile-things attack me-me for this is blasphemy!	false
scripted_subtitles_localised_text_wh2_main_qb_skv_skrolk_rod_of_corruption_stage_3_isle_of_the_crimson_skull_pt_03	Lead me to the Crimson Skull so I make it powder and restore my Rod of Corruption, yes-yes!	false
scripted_subtitles_localised_text_wh2_main_qb_skv_skrolk_rod_of_corruption_stage_3_isle_of_the_crimson_skull_pt_04	Let us begin - yes-yes!  	false
scripted_subtitles_localised_text_wh2_main_qb_skv_skrolk_the_liber_bubonicus_stage_3_mortuary_of_tzulaqua_pt_01	Quick-quick, get my book!	false
scripted_subtitles_localised_text_wh2_main_qb_skv_skrolk_the_liber_bubonicus_stage_3_mortuary_of_tzulaqua_pt_02	Ignore the Dead-things. Fight them. Kill or be killed; does not matter!	false
scripted_subtitles_localised_text_wh2_main_qb_skv_skrolk_the_liber_bubonicus_stage_3_mortuary_of_tzulaqua_pt_03	Only Liber Bubonicus matters. First get-get these corpses out of my way! Kill-slay zombie summoners!	false
scripted_subtitles_localised_text_wh2_main_qb_skv_skrolk_the_liber_bubonicus_stage_3_mortuary_of_tzulaqua_pt_04	Do as I bid - Clan Pestilens supreme!	false
scripted_subtitles_localised_text_wh2_twa03_Rakarth_QB_Whip_Of_Agony_pt_01	Cowardly wretches, hiding from your betters. Your tricks will not protect you from the onslaught of my beasts!	false
scripted_subtitles_localised_text_wh2_twa03_Rakarth_QB_Whip_Of_Agony_pt_02	They think to free their cold-blooded kin? Their freedom will be found only in obedience.	false
scripted_subtitles_localised_text_wh2_twa03_Rakarth_QB_Whip_Of_Agony_pt_03	Foolish Nakai, you are nothing but another beast to be broken!	false
scripted_subtitles_localised_text_wh2_twa03_Rakarth_QB_Whip_Of_Agony_pt_04	I will teach this reptillian scum what it means to truly dominate your foes. 	false
scripted_subtitles_localised_text_wh2_twa03_Rakarth_QB_Whip_Of_Agony_pt_05	We shall send these insolent currs scurrying back to their jungles in fear, as I bend their revered spirit to my will!	false
scripted_subtitles_localised_text_wh2_twa03_def_Rakarth_final_battle_pt_01	Though I care little for the Witch King’s schemes, we have a deal.	false
scripted_subtitles_localised_text_wh2_twa03_def_Rakarth_final_battle_pt_02	Once the Vortex is secured, the world will bow to Druchii power and my beastly legions shall be granted the highest position in his military echelons.	false
scripted_subtitles_localised_text_wh2_twa03_def_Rakarth_final_battle_pt_03	The rats and their Horned God shall not prevent my glory.	false
scripted_subtitles_localised_text_wh2_twa03_def_Rakarth_final_battle_pt_04	They are no mere beasts to be tamed, their only destiny is destruction. I will deliver it!	false
scripted_subtitles_localised_text_wh3_belakor_final_survival_01	I sit upon the precipice of godhood, and you have the gall to believe that the bear’s carrion is yours? Come then, try and take it!	false
scripted_subtitles_localised_text_wh3_belakor_final_survival_02	You built an empire to sustain this futile quest – that is the first thing I shatter after my ascension. As I feast on Ursun’s power, my Soul-Grinders shall feed on yours… 	false
scripted_subtitles_localised_text_wh3_belakor_final_survival_03	I may not be a god yet… but you will *suffer*	false
scripted_subtitles_localised_text_wh3_belakor_final_survival_04	My majesty!	false
scripted_subtitles_localised_text_wh3_dlc20_qb_all_altar_of_battle_reveal_01	For Chaos to achieve total destruction of the mortal realm, one God cannot dominate the others. 	false
scripted_subtitles_localised_text_wh3_dlc20_qb_all_altar_of_battle_reveal_02	The Everchosen comes to stop the final ritual!	false
scripted_subtitles_localised_text_wh3_dlc20_qb_all_altar_of_battle_reveal_03	Do not meddle in my destiny!	false
scripted_subtitles_localised_text_wh3_dlc20_qb_azazel_altar_of_battle_intro_01	Finally, my destiny has arrived. The spoils within that Altar ensure a place at my master’s side. N’Kari… Sigvald… will not even be worthy enough to kiss my claw!	false
scripted_subtitles_localised_text_wh3_dlc20_qb_azazel_altar_of_battle_intro_02	First, I must break open the Altar to gain the Dark Prince’s favour. It shall be my greatest endeavour!	false
scripted_subtitles_localised_text_wh3_dlc20_qb_azazel_altar_of_battle_intro_03	I need only claim enough of the Altar’s Marks of Power – and depose any who dare get in my way! What fun we shall have!	false
scripted_subtitles_localised_text_wh3_dlc20_qb_azazel_altar_of_battle_intro_04	So, the Blood God sends forth his murderous peons…	false
scripted_subtitles_localised_text_wh3_dlc20_qb_azazel_altar_of_battle_intro_05	Mindless bludgeons! Unworthy of my time. Have my minions see to them!	false
scripted_subtitles_localised_text_wh3_dlc20_qb_azazel_altar_of_battle_intro_06	There is only one champion worthy of the spoils inside that Altar – and it is not Khorne’s!	false
scripted_subtitles_localised_text_wh3_dlc20_qb_azazel_altar_of_battle_reveal_04	You are nothing to me, Everchosen!	false
scripted_subtitles_localised_text_wh3_dlc20_qb_azazel_altar_of_battle_wave_01	Nurgle’s maggots approach. They dare try to claim what is mine! I best disabuse them of this notion.	false
scripted_subtitles_localised_text_wh3_dlc20_qb_azazel_altar_of_battle_wave_02	Finally, Tzeentch’s machinations reveal themselves. They will not stop me! It is my right to feel the Dark Prince’s caress!	false
scripted_subtitles_localised_text_wh3_dlc20_qb_azazel_altar_of_battle_wave_03	At last - the Altar is mine to defile!	false
scripted_subtitles_localised_text_wh3_dlc20_qb_festus_altar_of_battle_intro_01	Despair all ye realms, the Leechlord has come, the sad days of this world are nearing their sum! 	false
scripted_subtitles_localised_text_wh3_dlc20_qb_festus_altar_of_battle_intro_02	Mmmm, the sweet stench of death, of souls trapped… Nurgle’s tribute still locked behind the Altar’s seal…	false
scripted_subtitles_localised_text_wh3_dlc20_qb_festus_altar_of_battle_intro_03	But what do we have here? Marks of Power to claim… power to conquer the Altar. Nurgle’s chosen shall deliver His prize!	false
scripted_subtitles_localised_text_wh3_dlc20_qb_festus_altar_of_battle_intro_04	Well met, Children of the Changer! Do you come to meet your sickly fates early?	false
scripted_subtitles_localised_text_wh3_dlc20_qb_festus_altar_of_battle_intro_05	The puppet master’s puppets will all soon be servants of decay, along with the rest of the world!	false
scripted_subtitles_localised_text_wh3_dlc20_qb_festus_altar_of_battle_intro_06	O ye faithful of the Fly Lord, fill their breeches with soil, the time has come for a bit of deathly toil!	false
scripted_subtitles_localised_text_wh3_dlc20_qb_festus_altar_of_battle_reveal_04	The Undivided are undeserving of Ruinous glory! You shall rot into nothingness, Everchosen!	false
scripted_subtitles_localised_text_wh3_dlc20_qb_festus_altar_of_battle_wave_01	Do not resist, slaves of Slaanesh! Once the world is Nurgle’s dominion, you too can be my plague-carriers. Your unsanitary ways will come in handy to spread His pestilent ruin!	false
scripted_subtitles_localised_text_wh3_dlc20_qb_festus_altar_of_battle_wave_02	Khorne sends His angry little thralls, and not just for fighting’s sake methinks. He knows! Once the Urfather’s power rises, His followers will not be spared the world’s despair!	false
scripted_subtitles_localised_text_wh3_dlc20_qb_festus_altar_of_battle_wave_03	The other Gods’ children are proven unworthy! The sickly blessings of Nurgle shall be ours!	false
scripted_subtitles_localised_text_wh3_dlc20_qb_kor_valkia_spear_slaupnir_pt_01	Sweet boons of war! I come for the Bloodfather’s gifts, yet it seems I will get even more.	false
scripted_subtitles_localised_text_wh3_dlc20_qb_kor_valkia_spear_slaupnir_pt_02	How fond I am of the quarrelsome, green-skinned simpletons. So easy to slay, yet just as easy to bring to battle!	false
scripted_subtitles_localised_text_wh3_dlc20_qb_kor_valkia_spear_slaupnir_pt_03	And the ratmen, craven they may be, but always willing to brawl for their worthless lives.	false
scripted_subtitles_localised_text_wh3_dlc20_qb_kor_valkia_spear_slaupnir_pt_04	Perhaps some will be worthy enough to stay here and fight for Khorne forever. Let us find out!	false
scripted_subtitles_localised_text_wh3_dlc20_qb_nur_festus_pestilent_potions_pt_01	Aches, pains, malady, malaise, Nurgle works in mysterious ways!	false
scripted_subtitles_localised_text_wh3_dlc20_qb_nur_festus_pestilent_potions_pt_02	I’d come to his realm for a good harvest, but nowt so close to being this marvellous!	false
scripted_subtitles_localised_text_wh3_dlc20_qb_nur_festus_pestilent_potions_pt_03	Ten CC’s of Jabberslythe bile…	false
scripted_subtitles_localised_text_wh3_dlc20_qb_nur_festus_pestilent_potions_pt_04	...mixed with a Cygor’s vitreous humour, makes for ulcers, cankers and tumours!	false
scripted_subtitles_localised_text_wh3_dlc20_qb_nur_festus_pestilent_potions_pt_05	Steel yourselves, servants of blight, the beasties are always up for a fight!	false
scripted_subtitles_localised_text_wh3_dlc20_qb_sla_azazel_daemonblade_01	Ahh, Morathi sends me some fresh delicacies from the mortal realm.	false
scripted_subtitles_localised_text_wh3_dlc20_qb_sla_azazel_daemonblade_02	Little Elven souls to be plucked like ripe fruit. So sweet to taste.	false
scripted_subtitles_localised_text_wh3_dlc20_qb_sla_azazel_daemonblade_03	I know they say it is bad manners to play with your food, but I can't help but sample their agony.	false
scripted_subtitles_localised_text_wh3_dlc20_qb_sla_azazel_daemonblade_04	There is something delicious about a soul that has no hope!	false
scripted_subtitles_localised_text_wh3_dlc20_qb_sla_azazel_daemonblade_05	Ready your blades, minions, for it is time to consume!	false
scripted_subtitles_localised_text_wh3_dlc20_qb_tze_vilitch_vessel_of_chaos_01	Thomin, dear brother, I comprehend the task our master has given us.	false
scripted_subtitles_localised_text_wh3_dlc20_qb_tze_vilitch_vessel_of_chaos_02	Ahh, Yes, I see! The Changer of Ways has delivered to us the two great empires of this world.	false
scripted_subtitles_localised_text_wh3_dlc20_qb_tze_vilitch_vessel_of_chaos_03	First come the dogs of the Empire. But the cattle of Cathay are not far behind!	false
scripted_subtitles_localised_text_wh3_dlc20_qb_tze_vilitch_vessel_of_chaos_04	Patience, brother! I foresee there are plenty of bones for you to break, flesh for you to tear.	false
scripted_subtitles_localised_text_wh3_dlc20_qb_tze_vilitch_vessel_of_chaos_05	But first we must soften them up, for the tortures to come!	false
scripted_subtitles_localised_text_wh3_dlc20_qb_valkia_altar_of_battle_intro_01	What a glorious journey of slaughter it has been! Soon we shall unleash the true savagery of Khorne upon the world!	false
scripted_subtitles_localised_text_wh3_dlc20_qb_valkia_altar_of_battle_intro_02	For now, the Altar’s seal endures, withholding my paramour’s tribute. How His brother-gods must gaze upon us and laugh…	false
scripted_subtitles_localised_text_wh3_dlc20_qb_valkia_altar_of_battle_intro_03	But let them laugh! Once we claim enough of the Altar’s Marks of Power, no challenger will stop us from taking the Bloodfather’s dues!	false
scripted_subtitles_localised_text_wh3_dlc20_qb_valkia_altar_of_battle_intro_05	The debauched ways of Slaanesh will be a mere sideshow to the world's Ruin. In the end, there can only be murder!	false
scripted_subtitles_localised_text_wh3_dlc20_qb_valkia_altar_of_battle_intro_06	They will fall before Khorne’s chosen! Clear the Altar of this fodder!	false
scripted_subtitles_localised_text_wh3_dlc20_qb_valkia_altar_of_battle_reveal_04	With the Gods as my witness, I will prove you unworthy of being the Everchosen, pretender!	false
scripted_subtitles_localised_text_wh3_dlc20_qb_valkia_altar_of_battle_wave_01	Tzeentch’s arduous plans are being undone, for he sends a cowardly host! The destruction of the mortal realm can only be by the reaping of blood and skulls – not conniving and conjuration!	false
scripted_subtitles_localised_text_wh3_dlc20_qb_valkia_altar_of_battle_wave_02	Nurgle must want me to put his lepers out of their misery! After all, a world abound with a million hosts of Khorne will have no need for the Rot-God’s influence!	false
scripted_subtitles_localised_text_wh3_dlc20_qb_valkia_altar_of_battle_wave_03	The pathetic challengers are no more! Finally we will claim the Bloodfather’s tribute!	false
scripted_subtitles_localised_text_wh3_dlc20_qb_vilitch_altar_of_battle_intro_01	See, brother! This has all happened according to our design.	false
scripted_subtitles_localised_text_wh3_dlc20_qb_vilitch_altar_of_battle_intro_02	That power is mine! And all those that have mocked us shall suffer!	false
scripted_subtitles_localised_text_wh3_dlc20_qb_vilitch_altar_of_battle_intro_03	No, fool! The Altar remains locked for now, but I know the way to access it.	false
scripted_subtitles_localised_text_wh3_dlc20_qb_vilitch_altar_of_battle_intro_04	Get us those Marks of Power – do not disappoint me – they are the key to breaking open the Altar’s seal!	false
scripted_subtitles_localised_text_wh3_dlc20_qb_vilitch_altar_of_battle_intro_05	Does the Urfather send his slaves against us? We shall deal with them – time to clean up!	false
scripted_subtitles_localised_text_wh3_dlc20_qb_vilitch_altar_of_battle_intro_06	None shall stop us, brother! I have foreseen it!	false
scripted_subtitles_localised_text_wh3_dlc20_qb_vilitch_altar_of_battle_reveal_04	We have bested you before, Everchosen, and will again. Ask Jharkill!	false
scripted_subtitles_localised_text_wh3_dlc20_qb_vilitch_altar_of_battle_thomin	[[col:blue]]…![[/col]]	false
scripted_subtitles_localised_text_wh3_dlc20_qb_vilitch_altar_of_battle_wave_01	Yes, Thomin! More creatures for you to mangle. Khorne’s puppets are nothing against our might!	false
scripted_subtitles_localised_text_wh3_dlc20_qb_vilitch_altar_of_battle_wave_02	Pitiful Slaanesh. The young are always the last to know. There are no secrets here. Only the truth that the Altar is ours!	false
scripted_subtitles_localised_text_wh3_dlc20_qb_vilitch_altar_of_battle_wave_03	Brother, it is finally ours!	false
scripted_subtitles_localised_text_wh3_dlc23_chd_drazhoath_hellshard_amulet_pt_01	I will not have these foul Undead defile my domain, and disrupt production! 	false
scripted_subtitles_localised_text_wh3_dlc23_chd_drazhoath_hellshard_amulet_pt_02	Annihilate them! I want to see nothing but burnt bones.	false
scripted_subtitles_localised_text_wh3_dlc23_chd_drazhoath_hellshard_amulet_pt_03	The Legion of Azgorh goes to battle. Any that do not perform shall answer to me!	false
scripted_subtitles_localised_text_wh3_dlc23_chd_intro_final_battle_01	The ultimate blessings of Hashut are nigh.	false
scripted_subtitles_localised_text_wh3_dlc23_chd_intro_final_battle_02	Bound to the Great Drill, the Ancestor relics cede their power to the diabolical machine. 	false
scripted_subtitles_localised_text_wh3_dlc23_chd_intro_final_battle_03	A terrifying feat of forge-craft to bore into the Chaos Realm.	false
scripted_subtitles_localised_text_wh3_dlc23_chd_intro_final_battle_04	The blood of the Bull-God, now at the fingertips of the worthiest Dawi-Zharr.	false
scripted_subtitles_localised_text_wh3_dlc23_chd_intro_final_battle_05	Yet there are those who seek to interfere with Hashut’s plan.	false
scripted_subtitles_localised_text_wh3_dlc23_chd_intro_final_battle_06	The Dawi seek vengeance for the pilfering of their relics!	false
scripted_subtitles_localised_text_wh3_dlc23_chd_intro_final_battle_07	By braving this place, they surely bring doom upon themselves.	false
scripted_subtitles_localised_text_wh3_dlc23_chd_intro_final_battle_astragoth	Hashut's wrath comes for all of you!	false
scripted_subtitles_localised_text_wh3_dlc23_chd_intro_final_battle_drazhoath	Burn the Dwarfs in sorcerous fire!	false
scripted_subtitles_localised_text_wh3_dlc23_chd_intro_final_battle_zhatan	Such fools. I'll take great pleasure in purging them!	false
scripted_subtitles_localised_text_wh3_dlc23_chd_mid_final_battle_01	Without warning, the igneous barrier between worlds is suddenly breached…	false
scripted_subtitles_localised_text_wh3_dlc23_chd_mid_final_battle_02	...but the Sorcerer-Prophets struggle to contain the torrent of escaping Chaos magic.	false
scripted_subtitles_localised_text_wh3_dlc23_chd_mid_final_battle_03	Other Daemonic powers are seizing their moment, bringing forth horrors from the other side that thirst for slaughter!	false
scripted_subtitles_localised_text_wh3_dlc23_chd_mid_final_battle_04	The Dawi-Zharr must ensure that only Hashut prevails!	false
scripted_subtitles_localised_text_wh3_dlc23_chd_outro_final_battle_01	With the Chaos magic contained, the Blood of Hashut flows forth.	false
scripted_subtitles_localised_text_wh3_dlc23_chd_outro_final_battle_02	But there is one final challenge to this unlimited power. The grudge-bearer and his cronies approach!	false
scripted_subtitles_localised_text_wh3_dlc23_chd_thorgrim_final_battle_01	There! There they are. The traitors… the grudge-mongers… the vile wretched Dawi-scum that have fled the love of our Ancestors!	false
scripted_subtitles_localised_text_wh3_dlc23_chd_thorgrim_final_battle_02	We stop this abomination that burrows into the rock! A machine powered by remnants of our gods. Such desecration must be answered in kind. I will tear out every page of the Dammaz Kron to address this most wanton of grudges!	false
scripted_subtitles_localised_text_wh3_dlc23_chd_thorgrim_final_battle_03	Loyal Dwarfs, the clans of the Karaz Ankor unite! Ready your axes, cleave the heads of every Dawi-Zharr you come across. Burn their beards! Dreng them! DRENG THEM ALL!	false
scripted_subtitles_localised_text_wh3_dlc23_chd_zhatan_chaos_runeshield_pt_01	The conclave of Zharr-Naggrund sends me to investigate this deficit in production. An insult and waste of my time!	false
scripted_subtitles_localised_text_wh3_dlc23_chd_zhatan_chaos_runeshield_pt_02	I’ll make these work-shy scum pay for this distraction! And then I’ll see the Overseers turned to ash.	false
scripted_subtitles_localised_text_wh3_dlc23_chd_zhatan_chaos_runeshield_pt_03	All here will suffer the wrath of Zhatan the Black!	false
scripted_subtitles_localised_text_wh3_dlc23_qb_chd_astragoth_black_hammer_of_hashut_pt_01	The fools in Zharr-Naggrund think to unmake my majesty, and so my legions will ensure the safety of this Convoy. Have the thralls load it up! Prepare to leave!	false
scripted_subtitles_localised_text_wh3_dlc23_qb_chd_astragoth_black_hammer_of_hashut_pt_02	Enemies are close... I can feel it it as much as the stone-dust in my blood.	false
scripted_subtitles_localised_text_wh3_dlc23_qb_chd_astragoth_black_hammer_of_hashut_pt_03	Once the Convoy reaches the clearing no enemy will dare to attack us, and victory will be mine!	false
scripted_subtitles_localised_text_wh3_dlc24_qb_cth_yuan_bo_dragons_fang_pt_01	These traitors have fled back to their vile benefactor and revealed the source of the pox on our lands.	false
scripted_subtitles_localised_text_wh3_dlc24_qb_cth_yuan_bo_dragons_fang_pt_02	This virulent mire may be their domain, but I know you brave and true warriors of Cathay will not shirk your duty.	false
scripted_subtitles_localised_text_wh3_dlc24_qb_cth_yuan_bo_dragons_fang_pt_03	Our enemies think themselves safe here, in their new home. But the Dragon Emperor's reach is long, and none can hide from his judgement.	false
scripted_subtitles_localised_text_wh3_dlc24_qb_cth_yuan_bo_dragons_fang_pt_04	The turncoat pawns shield their bloated master. Our fallen countrymen must be dispatched first.	false
scripted_subtitles_localised_text_wh3_dlc24_qb_cth_yuan_bo_dragons_fang_pt_05	And then, the Executioner’s axe comes for the Daemon. Once it has fallen, harmony will be restored to Grand Cathay!	false
scripted_subtitles_localised_text_wh3_dlc24_qb_ksl_mother_ostankya_crown_of_claws_pt_01	A great reservoir of magic lurks below, revealed to me by the spirits of home...	false
scripted_subtitles_localised_text_wh3_dlc24_qb_ksl_mother_ostankya_crown_of_claws_pt_02	The entrance is close… but so too come the three Beastmasters, just as foretold.	false
scripted_subtitles_localised_text_wh3_dlc24_qb_ksl_mother_ostankya_crown_of_claws_pt_03	The Naggarothi are as children in their weakness to corruption by power.	false
scripted_subtitles_localised_text_wh3_dlc24_qb_ksl_mother_ostankya_crown_of_claws_pt_04	They may cower behind their beasts of burden, but they must never enter that cave.	false
scripted_subtitles_localised_text_wh3_dlc24_qb_ksl_mother_ostankya_crown_of_claws_pt_05	To the spirit realm with you, creatures! I will send your masters into the dirt.	false
scripted_subtitles_localised_text_wh3_dlc24_qb_ksl_mother_ostankya_crown_of_claws_pt_06	Then at the last… the cave’s guardian to slay. Fire up my cauldron, daughters!	false
scripted_subtitles_localised_text_wh3_dlc24_qb_tze_the_changeling_the_tricksters_staff_pt_01	What is the worth of mortal life without a little Chaos?	false
scripted_subtitles_localised_text_wh3_dlc24_qb_tze_the_changeling_the_tricksters_staff_pt_02	Let the Dawi think they have a chance… even if they live long enough, the truth will not spare them from slaughter.	false
scripted_subtitles_localised_text_wh3_dlc24_qb_tze_the_changeling_the_tricksters_staff_pt_03	Taketh from one, giveth to another… the Dwarfs’ pride makes them such low-hanging fruit.	false
scripted_subtitles_localised_text_wh3_dlc24_qb_tze_the_changeling_the_tricksters_staff_pt_04	And men, so blinded by their greed that they do not even care that they fight alongside Tzeentch’s hosts!	false
scripted_subtitles_localised_text_wh3_dlc24_qb_tze_the_changeling_the_tricksters_staff_pt_05	What a shame the others do not want to come out and play. Should they learn the truth, perhaps they will.	false
scripted_subtitles_localised_text_wh3_dlc24_qb_tze_the_changeling_the_tricksters_staff_pt_06	My staff has merely been the carrot, and I am the stick. Let the game begin!	false
scripted_subtitles_localised_text_wh3_dlc25_dwf_malakai_dragon_hunters_cutscene_01	Come on, who's scared of a little Dragon? Think of the opportunities!	false
scripted_subtitles_localised_text_wh3_dlc25_dwf_malakai_dragon_hunters_cutscene_02	Oh look, elgi on their fancy ponies. Time for some target practice!	false
scripted_subtitles_localised_text_wh3_dlc25_dwf_malakai_dragon_hunters_cutscene_03	Woah, that's a big lizard! Ready the cannons, Dawi! Gold for the one who takes its eye out!	false
scripted_subtitles_localised_text_wh3_dlc25_dwf_malakai_dreadquake_destruction_cutscene_01	Oh, we've caught him with his pants down!	false
scripted_subtitles_localised_text_wh3_dlc25_dwf_malakai_dreadquake_destruction_cutscene_02	Run out of ammo have you? What a shame!	false
scripted_subtitles_localised_text_wh3_dlc25_dwf_malakai_dreadquake_destruction_cutscene_03	Now's our chance! Get the blasted Frundrar!	false
scripted_subtitles_localised_text_wh3_dlc25_dwf_malakai_exalted_bloodthirst_cutscene_01	Put a few holes in 'em to get the guns calibrated, then the boss'll come running!	false
scripted_subtitles_localised_text_wh3_dlc25_dwf_malakai_exalted_bloodthirst_cutscene_02	They underestimated us! Bloody idiots!	false
scripted_subtitles_localised_text_wh3_dlc25_dwf_malakai_exalted_bloodthirst_cutscene_03	Here we go, let's get stuck in! Glory!	false
scripted_subtitles_localised_text_wh3_dlc25_dwf_malakai_malevolent_tree_spirits_cutscene_01	So that's who's been riling them up! Don't burn all of him, he'll be perfect material for some side projects!	false
scripted_subtitles_localised_text_wh3_dlc25_dwf_malakai_malevolent_tree_spirits_cutscene_02	They picked the wrong day to be made of wood!	false
scripted_subtitles_localised_text_wh3_dlc25_dwf_malakai_malevolent_tree_spirits_cutscene_03	Pity that's all of them, I was enjoying th-- Wait a minute. Spoke too soon! Incoming!	false
scripted_subtitles_localised_text_wh3_dlc25_dwf_malakai_malevolent_tree_spirits_cutscene_04	Get re-sighted lads! They got more stuff for us to shoot!	false
scripted_subtitles_localised_text_wh3_dlc25_dwf_malakai_undead_empowered_pt_01	Let them come and try us! We'll kill 'em again!	false
scripted_subtitles_localised_text_wh3_dlc25_dwf_malakai_undead_empowered_pt_02	It's that ugly one in the robe doing this! Shoot that one!	false
scripted_subtitles_localised_text_wh3_dlc25_dwf_malakai_undead_empowered_pt_03	There's nothing better than fireworks that hit things!	false
scripted_subtitles_localised_text_wh3_dlc25_dwf_malakai_undead_empowered_pt_04	The boss has finally shown his face! Get 'im in your crosshairs, if you have them!	false
scripted_subtitles_localised_text_wh3_dlc25_dwf_malakai_warpstone_bomb_cutscene_01	This doesn't look good! We've got to get over there!	false
scripted_subtitles_localised_text_wh3_dlc25_dwf_malakai_warpstone_bomb_cutscene_02	Got to smash through these guys so I can get to defusing!	false
scripted_subtitles_localised_text_wh3_dlc25_dwf_malakai_warpstone_bomb_cutscene_03	Get going! Oh, and someone get me a drink, I need to steady my nerves!	false
scripted_subtitles_localised_text_wh3_dlc25_nemesis_crown_final_battle_01_elspeth	Resting upon a vile Greenskin brow, the Nemesis Crown wreaks untold damage, seeding death in lands Elspeth von Draken has sworn to defend.	false
scripted_subtitles_localised_text_wh3_dlc25_nemesis_crown_final_battle_01_malakai	Bearing the shame of Alaric the Mad, the grobi menace marches to war, swarming beneath the Nemesis Crown's corruption.	false
scripted_subtitles_localised_text_wh3_dlc25_nemesis_crown_final_battle_01_tamurkhan	Unworthy hands clutch at the Nemesis Crown, wielding the coveted powers of domination that the Maggot Lord demands.	false
scripted_subtitles_localised_text_wh3_dlc25_nemesis_crown_final_battle_02_alternate	Though the Greenskin leadership lies in tatters, this rearing serpent still bears fangs in need of ripping out…	false
scripted_subtitles_localised_text_wh3_dlc25_nemesis_crown_final_battle_02_default	Every banner the Greenskins march beneath must be torn asunder, if the Crown is ever to be wrested from their grasp.	false
scripted_subtitles_localised_text_wh3_dlc25_nemesis_crown_final_battle_03	To the west, the Night Goblins amass in force, relishing the chance to bloody their wicked blades.	false
scripted_subtitles_localised_text_wh3_dlc25_nemesis_crown_final_battle_04	All the while, the spiders creep onwards from the east, and a million blinking eyes grow ever closer.	false
scripted_subtitles_localised_text_wh3_dlc25_nemesis_crown_final_battle_05	But heavy is the head that wears the crown... Cut it off, and this war host may scatter with the wind.	false
scripted_subtitles_localised_text_wh3_dlc25_nemesis_crown_final_battle_06_elspeth	Weave death among this filth ‬– they have tainted our lands long enough!	false
scripted_subtitles_localised_text_wh3_dlc25_nemesis_crown_final_battle_06_malakai	Tek the heeds off this grobi scum! Today we undo Alaric's shame!	false
scripted_subtitles_localised_text_wh3_dlc25_nemesis_crown_final_battle_06_tamurkhan	That'll be my crown! My power! Crush 'em all into a feast for the flies!	false
scripted_subtitles_localised_text_wh3_dlc25_neu_gotrek_felix_pt_01	As the Day of Mystery thins the veil between worlds, Slaanesh enacts his vengeance, dragging enemies from across the mortal world into His dark realm. Among the captured, the rogues Gotrek and Felix fight, battling to escape the Prince of Pleasure's domain.	false
scripted_subtitles_localised_text_wh3_dlc25_neu_gotrek_felix_pt_02	Only destroying His arcane portals would weaken the Dark Prince's grip, yet those protecting them will demand a toll in blood…	false
scripted_subtitles_localised_text_wh3_dlc25_neu_gotrek_felix_pt_03	No matter the price, Gotrek and Felix cannot fall, for their survival will deal Slaanesh a deadly blow, and prove vital in the adventures to come!	false
scripted_subtitles_localised_text_wh3_dlc25_qb_dwf_malakai_eyes_of_grungni_01	It was a canny trick our brother used in bringing us here. I'd expect nothing less of an Engineer. Now... safeties off lads! Let's free our kin with our umgi allies, shall we?	false
scripted_subtitles_localised_text_wh3_dlc25_qb_dwf_malakai_eyes_of_grungni_02	I bet there's all kinds of poor saps trapped in those mines. Our Engineer friend could free 'em if we provide some good old "blackpowder distraction"!	false
scripted_subtitles_localised_text_wh3_dlc25_qb_dwf_malakai_eyes_of_grungni_03	Those Dark Elf wazzocks aren't going to know what's hit 'em! Whatever that Black Ark throws at us, we'll crack their heads and send 'em packing back to Naggaroth!	false
scripted_subtitles_localised_text_wh3_dlc25_qb_dwf_malakai_spider_swarm_pt_01	Somewhere 'round here is the eight-legged wazzock we're looking for…	false
scripted_subtitles_localised_text_wh3_dlc25_qb_dwf_malakai_spider_swarm_pt_02	Stay sharp, lads, we're not alone. I smell the stench of Goblins up ahead…	false
scripted_subtitles_localised_text_wh3_dlc25_qb_dwf_malakai_spider_swarm_pt_03	No matter, though, 'cos our Hewers will make short work of 'em!	false
scripted_subtitles_localised_text_wh3_dlc25_qb_dwf_malakai_spider_swarm_pt_04	Steel yerselves, lads, our quarry is close now…	false
scripted_subtitles_localised_text_wh3_dlc25_qb_dwf_malakai_spider_swarm_pt_05	Watch yerselves, the Brood Mother is a monstrous beast for sure. When we put her down, the glory will be all ours!	false
scripted_subtitles_localised_text_wh3_dlc25_qb_emp_elspeth_deaths_timekeeper_01	These harbingers of Chaos bring nothing but death and destruction to our lands. These souls may be lost, but I shall not cower while the slaughter continues…	false
scripted_subtitles_localised_text_wh3_dlc25_qb_emp_elspeth_deaths_timekeeper_02	I know not what Daemonic horrors await beyond their portals, and I do not plan to find out!	false
scripted_subtitles_localised_text_wh3_dlc25_qb_emp_elspeth_deaths_timekeeper_03	Their sacrificial rites must end, now – my Pale Scythe will see to it, one way or another... 	false
scripted_subtitles_localised_text_wh3_dlc25_qb_emp_elspeth_deaths_timekeeper_04	Either it cleaves their cultist in twain to halt the foul magics of his ritual, or weakens the awaiting Daemons by ending his victims' misery.	false
scripted_subtitles_localised_text_wh3_dlc25_qb_emp_elspeth_deaths_timekeeper_05	Whatever the outcome, we will soak this battlefield in blood and the Winds of Shyish shall blow a gale.	false
scripted_subtitles_localised_text_wh3_dlc25_qb_emp_elspeth_deaths_timekeeper_06	Virtue demands we spare them no mercy!	false
scripted_subtitles_localised_text_wh3_dlc25_qb_nur_epidemius_sands_of_sickness_01	The Urfather's gifts have found their way to the Asur!	false
scripted_subtitles_localised_text_wh3_dlc25_qb_nur_epidemius_sands_of_sickness_02	Look at how they suffer! Every cough, splatter and lax, glorious to behold.	false
scripted_subtitles_localised_text_wh3_dlc25_qb_nur_epidemius_sands_of_sickness_03	My host will give them life's final release, for that is what Nurgle demands.	false
scripted_subtitles_localised_text_wh3_dlc25_qb_nur_epidemius_sands_of_sickness_04	There shall be no cure for the death we bring!	false
scripted_subtitles_localised_text_wh3_dlc25_qb_nur_tamurkhan_chieftain_bray_shaman	To endure Hexensnacht will be no easy feat – even for a great warlord such as I – but the rewards will be worth this trial.	false
scripted_subtitles_localised_text_wh3_dlc25_qb_nur_tamurkhan_chieftain_castellan	Greenskin sorcery! These Shamans call upon an even more powerful idol. I will crush them to sever their link with the creature!	false
scripted_subtitles_localised_text_wh3_dlc25_qb_nur_tamurkhan_chieftain_exalted_hero	A vast host appears, belonging to Khargan's enemies. This rivalry ends now – then the Crazed one will serve the warband forever in my debt.	false
scripted_subtitles_localised_text_wh3_dlc25_qb_nur_tamurkhan_chieftain_fimir_balefiend	I have foreseen these unwelcome Daemons who corrupt Nurgle's realm. Ketzak now bids me to heed the call from beyond!	false
scripted_subtitles_localised_text_wh3_dlc25_qb_nur_tamurkhan_chieftain_kazyk	The hunger of the Great Unclean Ones is legendary, but this one turns its appetite on its own. For that, Nurgle will have me put it down.	false
scripted_subtitles_localised_text_wh3_dlc25_qb_nur_tamurkhan_chieftain_werekin	So, Skraelsbane has developed a taste for Skin Wolves? Norsca’s beasts could be useful to the warband – if we can prevent the wolf-kin’s doom.	false
scripted_subtitles_localised_text_wh3_dlc25_qb_nur_tamurkhan_gates_of_nuln_01	Mighty host of Nurgle, Nuln awaits us! Once the wriggling worms this side of the river are all dead, we'll march on their precious little city…	false
scripted_subtitles_localised_text_wh3_dlc25_qb_nur_tamurkhan_gates_of_nuln_02	First, we pulverise their flesh, then we will have our choice of crossings. Left bridge, right bridge – whichever we pick, it will be futile to resist us!	false
scripted_subtitles_localised_text_wh3_dlc25_qb_nur_tamurkhan_gates_of_nuln_03	The cowards think their rockets will stop us! But we will crush their little machines and grind the mewling spawn into paste.	false
scripted_subtitles_localised_text_wh3_dlc25_qb_nur_tamurkhan_gates_of_nuln_04	And more of the Empire's toys await us across the bridge, mounted by beady eyes. I will take pleasure in plucking them out.	false
scripted_subtitles_localised_text_wh3_dlc25_qb_nur_tamurkhan_gates_of_nuln_05	Then, to the city and its fodder. I am sure the garrison is eager for an audience with the Maggot Lord…	false
scripted_subtitles_localised_text_wh3_dlc25_qb_nur_tamurkhan_gates_of_nuln_06	My great conquest is finally at hand! Nuln and its souls, mine for the taking – gifts worthy of my rise to Daemonhood!	false
scripted_subtitles_localised_text_wh3_dlc26_forest_bane_01	"So, I’m hearin‘ da Beastmen don’t want us ‘ere for sum reason, boyz."	false
scripted_subtitles_localised_text_wh3_dlc26_forest_bane_02	"When I find ‘em, I’m gonna take their horns an’…"	false
scripted_subtitles_localised_text_wh3_dlc26_forest_bane_03	"Ah, dere dey are, right out in da open!"	false
scripted_subtitles_localised_text_wh3_dlc26_forest_bane_04	"Dem Beastmen are dumb, but they ain’t dat dumb... Keep yer eyez peeled for ambushes; they loves hidin’ in da trees."	false
scripted_subtitles_localised_text_wh3_dlc26_forest_bane_05	"Speakin’ of trees… da scouts say dey seen dem Treemen walkin’ round ‘ere, dey dun take well to our choppin’ neitha…"	false
scripted_subtitles_localised_text_wh3_dlc26_forest_bane_06	"But you gitz do what I says, an’ we’ll chop dem in dere stride."	false
scripted_subtitles_localised_text_wh3_dlc26_forest_bane_07	"Chop dem all down – trees, weaklingz, everythin'!"	false
scripted_subtitles_localised_text_wh3_dlc26_forest_bane_08	"‘Eads up, da woods are movin’ in for sum choppin’ too!"	false
scripted_subtitles_localised_text_wh3_dlc26_qb_kho_arbaal_destroyer_of_khorne_01	A haunted land, they call it. Yet the grasses do not scream. The stones don’t bleed. The trees don’t drip with burning souls.	false
scripted_subtitles_localised_text_wh3_dlc26_qb_kho_arbaal_destroyer_of_khorne_02	My Khorne-kin! What say you? How does this “haunted land” measure up against our Wastes?	false
scripted_subtitles_localised_text_wh3_dlc26_qb_kho_arbaal_destroyer_of_khorne_03	See them hiss and sputter!	false
scripted_subtitles_localised_text_wh3_dlc26_qb_kho_arbaal_destroyer_of_khorne_04	Death has withered their wits to stand against me!	false
scripted_subtitles_localised_text_wh3_dlc26_qb_kho_arbaal_destroyer_of_khorne_05	Under His gaze, I will unseam their flesh, and bare their souls to everlasting fires.	false
scripted_subtitles_localised_text_wh3_dlc26_qb_kho_arbaal_destroyer_of_khorne_06	This “haunted land” will earn its name today.	false
scripted_subtitles_localised_text_wh3_dlc26_qb_kho_arbaal_destroyer_of_khorne_07	Destruction.	false
scripted_subtitles_localised_text_wh3_dlc26_qb_kho_skulltaker_slayer_sword_01	Champions of stunted mortals... why sacrifice your chanceless servants when you can meet me on the frontline? Are you not worthy?	false
scripted_subtitles_localised_text_wh3_dlc26_qb_kho_skulltaker_slayer_sword_02	This place... This lingering stench of defeat. Sigmar should have died here. Today, you will die in his stead.	false
scripted_subtitles_localised_text_wh3_dlc26_qb_kho_skulltaker_slayer_sword_03	Dawi! Prove your worth! Show your strength so that I may imbibe it. For I thirst, and thirst!	false
scripted_subtitles_localised_text_wh3_dlc26_qb_kho_skulltaker_slayer_sword_04	Are your skulls but fodder for the Throne? Or are they destined for my mantle?	false
scripted_subtitles_localised_text_wh3_dlc26_qb_kho_skulltaker_slayer_sword_05	Battle reveals all.	false
scripted_subtitles_localised_text_wh3_dlc26_qb_kho_skulltaker_slayer_sword_06	Praise Khorne! Drench the fields with the blood of Sigmar’s slaves!	false
scripted_subtitles_localised_text_wh3_dlc26_qb_ogr_golgfag_bugmans_xxxxxx_01	Well, how’s about this? Gnashrak’s sorted us a good payday ‘ere.	false
scripted_subtitles_localised_text_wh3_dlc26_qb_ogr_golgfag_bugmans_xxxxxx_02	Just try not to snack on too many Goblins on tha job…	false
scripted_subtitles_localised_text_wh3_dlc26_qb_ogr_golgfag_bugmans_xxxxxx_03	Not that we’ve ever done that, of course.	false
scripted_subtitles_localised_text_wh3_dlc26_qb_ogr_golgfag_bugmans_xxxxxx_04	Right! We get up there, smash some Dwarfs, and get paid. But be sure to watch ya backs…	false
scripted_subtitles_localised_text_wh3_dlc26_qb_ogr_golgfag_bugmans_xxxxxx_05	"Oi! I thought I told yoos ta stop munchin’ on tha gobbos, ya git! Yer fired!"	false
scripted_subtitles_localised_text_wh3_dlc26_qb_ogr_golgfag_bugmans_xxxxxx_06	Ah shut it, why don’t ya!	false
scripted_subtitles_localised_text_wh3_dlc26_qb_ogr_golgfag_bugmans_xxxxxx_07	I’ve gone off Goblins, anyway! 'Orrible little pointy fings!	false
scripted_subtitles_localised_text_wh3_dlc26_qb_ogr_golgfag_bugmans_xxxxxx_08	Alright then, let’s see if these Dwarfs are hirin’ instead!	false
scripted_subtitles_localised_text_wh3_khorne_demo_intro_survival_01	Warriors of Kislev! We have travelled far and fought hard, but at last we have arrived in Khorne's bloody realm.	false
scripted_subtitles_localised_text_wh3_khorne_demo_intro_survival_02	Before us stands the Brass Citadel, where the Blood God's gatekeeper stands guard. We must call out the fiend, and slay him!	false
scripted_subtitles_localised_text_wh3_khorne_demo_intro_survival_03	He rallies his Daemons for a last, desperate defence. Vanquish them – with ice and steel! 	false
scripted_subtitles_localised_text_wh3_khorne_demo_intro_survival_04	This is the Ruined Fort, defended by Khorne's lesser thralls. Wipe them out and capture the Icon of Ruin. This will give me a foothold and grant us supplies, to reinforce for the struggle ahead.	false
scripted_subtitles_localised_text_wh3_khorne_demo_outro_survival_01	My brave Kislevites! We stand triumphant! But Khorne is not the only Dark God with a realm in this accursed place. The battle is won, but the war goes on... Come. We must continue our search for what is lost.	false
scripted_subtitles_localised_text_wh3_khorne_demo_reveal_survival_01	The Icon of Ruin is ours, and we have supplies to fortify our position.	false
scripted_subtitles_localised_text_wh3_khorne_demo_reveal_survival_02	Use them to construct defensive towers here.	false
scripted_subtitles_localised_text_wh3_khorne_demo_reveal_survival_03	We can barricade these bottlenecks.	false
scripted_subtitles_localised_text_wh3_khorne_demo_reveal_survival_04	Use the portals to summon fresh troops or heal and upgrade our warriors, using whatever supplies we have left.	false
scripted_subtitles_localised_text_wh3_khorne_demo_reveal_survival_05	Khorne's Daemons attack! Hold fast, warriors!	false
scripted_subtitles_localised_text_wh3_khorne_demo_reveal_survival_06	We must press on into the Blood Pits, and seize the Icon of Blood!	false
scripted_subtitles_localised_text_wh3_khorne_demo_reveal_survival_07	The Icon of Blood is ours! Beyond the portal wait Kislev's greatest defenders, ready to fight! Use the fresh supplies to summon them. Construct more towers and barricades to help the defence.	false
scripted_subtitles_localised_text_wh3_khorne_demo_reveal_survival_08	One final push, to the Boiling Moat! We must seize the Icon of Torment, and tempt Khorne's gatekeeper from his lair!	false
scripted_subtitles_localised_text_wh3_khorne_demo_reveal_survival_09	I claim the Icon of Torment – the Daemon will come! Use the last of our supplies to ready our defences. Raise towers! Raise barricades! And summon forth the greatest of the Motherland's Champions.	false
scripted_subtitles_localised_text_wh3_khorne_demo_reveal_survival_10	Khorne's Gatekeeper shows himself at last! Warriors of Kislev, prepare for the fight of your lives!	false
scripted_subtitles_localised_text_wh3_main_camp_narrative_chs_khorne_battle_intro_01	The Brass Citadel! The keep of the Blood God. Home of the Skull Throne. 	false
scripted_subtitles_localised_text_wh3_main_camp_narrative_chs_khorne_battle_intro_02	The Citadel is guarded by eight hundred and eighty-eight Bloodthirsters, but we need only breach its outer-defences to draw out the Gatekeeper.	false
scripted_subtitles_localised_text_wh3_main_camp_narrative_chs_khorne_battle_intro_03	Start at the Ruined Fort, defeat its garrison and capture the Icon of Ruin. This will give you a foothold and grant us supplies to reinforce for the struggle ahead. 	false
scripted_subtitles_localised_text_wh3_main_camp_narrative_chs_khorne_battle_intro_04	There are two other Icons you will need to capture and so dominate the battle. 	false
scripted_subtitles_localised_text_wh3_main_camp_narrative_chs_khorne_battle_intro_05	You have drawn the Blood God's gaze, make sure you are worthy of his attention. Let the slaughter begin!	false
scripted_subtitles_localised_text_wh3_main_camp_narrative_chs_khorne_battle_intro_06	Khorne's Gatekeeper! This is the Daemon Prince whose soul we seek. 	false
scripted_subtitles_localised_text_wh3_main_camp_narrative_chs_nurgle_battle_intro_01	The Mansion of the Plague Lord. The Crooked Manor of Nurgle.	false
scripted_subtitles_localised_text_wh3_main_camp_narrative_chs_nurgle_battle_intro_02	None would survive crossing its threshold, but the Gardener will come as soon as we trespass upon its outer-defences! 	false
scripted_subtitles_localised_text_wh3_main_camp_narrative_chs_nurgle_battle_intro_03	Capture the Canker-Tree in the Garden of Blight. This will give you a foothold and grant us supplies to reinforce for the struggle ahead. 	false
scripted_subtitles_localised_text_wh3_main_camp_narrative_chs_nurgle_battle_intro_04	There are two other Trees you will need to claim and so dominate the battle. 	false
scripted_subtitles_localised_text_wh3_main_camp_narrative_chs_nurgle_battle_intro_05	Nurgle is amused you have made it this far. Slay His servants and ensure He will not mock you again!	false
scripted_subtitles_localised_text_wh3_main_camp_narrative_chs_nurgle_battle_intro_06	There is the Gardener, Nurgle's Daemon Prince! Slay him!	false
scripted_subtitles_localised_text_wh3_main_camp_narrative_chs_slaanesh_battle_intro_01	The Palace of Slaanesh, where the Dark Prince's harem resides. 	false
scripted_subtitles_localised_text_wh3_main_camp_narrative_chs_slaanesh_battle_intro_02	A full-on incursion is not desired or warranted – we need only penetrate its outer-defences and the Courtesan shall reveal themselves.	false
scripted_subtitles_localised_text_wh3_main_camp_narrative_chs_slaanesh_battle_intro_03	Begin at the Wall of Twisted Flesh. Disperse its defenders and capture the Statue of Perfection. This will give you a foothold and grant us supplies to reinforce for the struggle ahead. 	false
scripted_subtitles_localised_text_wh3_main_camp_narrative_chs_slaanesh_battle_intro_04	There are two other statues you will need to capture and so dominate the battle. 	false
scripted_subtitles_localised_text_wh3_main_camp_narrative_chs_slaanesh_battle_intro_05	Slaanesh senses your desire to slay His chosen prince. Channel this to your own advantage, not His!	false
scripted_subtitles_localised_text_wh3_main_camp_narrative_chs_slaanesh_battle_intro_06	The Courtesan appears! We must kill this Daemon Prince and take their soul!	false
scripted_subtitles_localised_text_wh3_main_camp_narrative_chs_tzeentch_battle_intro_01	The Impossible Fortress… impregnable to all but the insane. 	false
scripted_subtitles_localised_text_wh3_main_camp_narrative_chs_tzeentch_battle_intro_02	To enter the Fortress unbidden would be a mistake, but piercing its defences will suffice to summon the wrath of the Librarian.	false
scripted_subtitles_localised_text_wh3_main_camp_narrative_chs_tzeentch_battle_intro_03	Control the Crystal of Lore in the labyrinth. This will give you a foothold and grant us supplies to reinforce for the struggle ahead.   	false
scripted_subtitles_localised_text_wh3_main_camp_narrative_chs_tzeentch_battle_intro_04	There are two other crystals you will need to capture and so dominate the battle. 	false
scripted_subtitles_localised_text_wh3_main_camp_narrative_chs_tzeentch_battle_intro_05	Confound the Great Changer! Refuse to play the part He has written for you, and destroy all who get in your way!	false
scripted_subtitles_localised_text_wh3_main_camp_narrative_chs_tzeentch_battle_intro_06	The Librarian is summoned! Execute Tzeentch's favoured Daemon Prince and steal his soul!	false
scripted_subtitles_localised_text_wh3_main_prologue_battle_1_001	The journey has been long, but we are ready. Fellow Ungols, we are of Kislev - show these cowardly dogs what that means. They hunger for blood, let them taste cold steel! 	false
scripted_subtitles_localised_text_wh3_main_prologue_battle_2_001	Let the Wolf believe he hunts! I say he is the prey! We use the high ground, and strike his pack low. For Kislev!	false
scripted_subtitles_localised_text_wh3_main_prologue_qb_brazen_altar_001	I need – Ursun needs – that Altar!	false
scripted_subtitles_localised_text_wh3_main_prologue_qb_brazen_altar_002	But it is defended by one of the Blood God's wretched pets!	false
scripted_subtitles_localised_text_wh3_main_prologue_qb_brazen_altar_003	You will fight, and some may die, for the Blood God demands blood, and we shall gladly give it!	false
scripted_subtitles_localised_text_wh3_main_prologue_qb_brazen_altar_004	All that matters is reaching the shrine.	false
scripted_subtitles_localised_text_wh3_main_prologue_qb_frost_maiden_001	Ursun is lost, but there is a way to find him within the maze!	false
scripted_subtitles_localised_text_wh3_main_prologue_qb_frost_maiden_002	Strike down the Daemons which guard its profane walls!	false
scripted_subtitles_localised_text_wh3_main_prologue_qb_howling_citadel_001	The traitor squanders his power!	false
scripted_subtitles_localised_text_wh3_main_prologue_qb_howling_citadel_002	He takes the role of petty warlord, bartering with marauder scum!	false
scripted_subtitles_localised_text_wh3_main_prologue_qb_howling_citadel_003	I have a Greater Daemon at my side… I will show them ALL how to wield true power!	false
scripted_subtitles_localised_text_wh3_main_qb_belakor_final_battle_01	I sit upon the precipice of Godhood, and you have the gall to believe that the Bear’s carrion is yours? Come then, try and take it!	false
scripted_subtitles_localised_text_wh3_main_qb_belakor_final_battle_02	You built an empire to sustain this futile quest – that is the first thing I shatter after my ascension. As I feast on Ursun’s power, my Soul-Grinders shall feed on yours… 	false
scripted_subtitles_localised_text_wh3_main_qb_belakor_final_battle_03	I may not be a god yet… but you will *suffer* my majesty!	false
scripted_subtitles_localised_text_wh3_main_qb_kho_skarbrand_the_brazen_altar_01	I am the spine-crusher… the skull-taker… the blood-quencher	false
scripted_subtitles_localised_text_wh3_main_qb_kho_skarbrand_the_brazen_altar_02	I am violence	false
scripted_subtitles_localised_text_wh3_main_qb_kho_skarbrand_the_brazen_altar_03	I am WAR	false
scripted_subtitles_localised_text_wh3_main_qb_kho_skarbrand_the_brazen_altar_04	I am WRATH	false
scripted_subtitles_localised_text_wh3_main_qb_kho_skarbrand_the_brazen_altar_05	I am RAGE INCARNATE	false
scripted_subtitles_localised_text_wh3_main_qb_kho_skarbrand_the_brazen_altar_06	I am Skarbrand, the UNFORGIVEN! 	false
scripted_subtitles_localised_text_wh3_main_qb_ksl_katarin_the_fractal_maze_01	A trap then! They come before we enter the Changer's maze. Clear the path my subjects, The Crystal Cloak was worn by the Khan-Queens of old. I claim it, and even the hexes of Tzeentch cannot overrule my birthright!	false
scripted_subtitles_localised_text_wh3_main_qb_ksl_katarin_the_fractal_maze_02	Steady your hearts, brothers and sisters of Kislev. The Great Deceiver sends his puppets, but the Motherland protects, embrace her and we will see victory!	false
scripted_subtitles_localised_text_wh3_main_qb_ksl_katarin_the_frozen_falls_01	My father! Already ensnared by Chaos magicks. Sons and daughters of Kislev, we will not let these foul puppets deprive us of Kislev's sire once more.	false
scripted_subtitles_localised_text_wh3_main_qb_ksl_katarin_the_frozen_falls_02	Steel your hearts – we fight to free the Red Tzar!	false
scripted_subtitles_localised_text_wh3_main_qb_ksl_kostaltyn_shrine_of_ursun_01	There! There the knife-eared devils come to take you from Ursun's grasp. To spirit you across the heathen waters where you will eke out your lives misery and toil in sin, far from Ursun's embrace! Is that what you want? IS IT?!	false
scripted_subtitles_localised_text_wh3_main_qb_ksl_kostaltyn_shrine_of_ursun_02	Then show me your hatred! If you love the Bear you will happily die rather than be taken.	false
scripted_subtitles_localised_text_wh3_main_qb_ksl_kostaltyn_the_frozen_falls_01	Ursun's chosen! Boris Ursus! Defiled by the sworn enemies of Father Bear! Sons and daughters of Kislev… GET THEM! Throw your bodies in front of their cursed blades. Do whatever you must to save the Red Tzar!	false
scripted_subtitles_localised_text_wh3_main_qb_nur_kugarth_the_fetid_underway_01	Slops-a-gravy, beggar's crumb. Finger-more and skip the thumb! I crave what a crave and that is Dwarfen-scum!	false
scripted_subtitles_localised_text_wh3_main_qb_nur_kugarth_the_fetid_underway_02	I will have their hands and heads in my vice… so best to infect them all with foetid beard-lice!	false
scripted_subtitles_localised_text_wh3_main_qb_nur_kugarth_the_fetid_underway_03	[Sinister but weirdly warm laugh – like that uncle you don't like laughing at his own joke]	false
scripted_subtitles_localised_text_wh3_main_qb_ogr_greasus_the_fire_mouth_01	My crown ain't as shiny as it used to be. 'at's your fault! You let this Orc rampage through my lands without giving 'im any bother! That stops now! This battle's goin' to be huuge, that ain't no lie! And no one lies betta dan me!	false
scripted_subtitles_localised_text_wh3_main_qb_ogr_greasus_the_fire_mouth_02	I brought this git here, now we goin' to swallow him whole, chew on his eyeballs and throw his nads into the Fire Mouth!	false
scripted_subtitles_localised_text_wh3_main_qb_ogr_greasus_the_fire_mouth_03	Right! Let's get to it!	false
scripted_subtitles_localised_text_wh3_main_qb_ogr_skrag_ice_caverns_of_ymirdrak_01	''ERE RATTY-RATTIES! 'ERE RATTY-RATTIES!	false
scripted_subtitles_localised_text_wh3_main_qb_ogr_skrag_ice_caverns_of_ymirdrak_02	Come and have a sniff of dis cheese. It’s all 'ere, in ma pot. Just scamper over and jump in!	false
scripted_subtitles_localised_text_wh3_main_qb_ogr_skrag_ice_caverns_of_ymirdrak_03	Oh Maw... they hang back... It's, it's a rat-trap! I ain't trapped 'ere with them…	false
scripted_subtitles_localised_text_wh3_main_qb_ogr_skrag_ice_caverns_of_ymirdrak_04	THEY'RE TRAPPED 'ERE WITH ME!	false
scripted_subtitles_localised_text_wh3_main_qb_sla_nkari_the_sea_of_dreams_01	You are in my way, Asur. Move aside and I may grant you a gift rarely bequeathed on my other playthings… a quick and mildly-painful death.	false
scripted_subtitles_localised_text_wh3_main_qb_sla_nkari_the_sea_of_dreams_02	But vex me and the agonies I shall visit upon you and your descendants will be as legend – sung in the halls of the Marcher Fortress for eternity!	false
scripted_subtitles_localised_text_wh3_main_qb_sla_nkari_the_sea_of_dreams_03	Bring them to me, my fiends – the feast begins!	false
scripted_subtitles_localised_text_wh3_main_qb_tze_kairos_ilses_of_time_01	We remember this. We recall being you!	false
scripted_subtitles_localised_text_wh3_main_qb_tze_kairos_ilses_of_time_02	You must relent, the Staff is ours! We will not be blinded to fate by your petty context!	false
scripted_subtitles_localised_text_wh3_main_qb_tze_kairos_ilses_of_time_03	Die! – so we can calibrate real-space… and witness the vast fractals of existence once more.	false
scripted_subtitles_localised_text_wh3_main_qb_tze_kairos_ilses_of_time_04	Minions, go forth. Sunder the inevitable!	false
scripted_subtitles_localised_text_wh3_main_st_battle_fundamentals_intro_0001	Battles are fought between armies of fighting troops. Your forces may be eager and ready to fight, yet only through your leadership may your troops gain victory.	false
scripted_subtitles_localised_text_wh3_main_st_battle_fundamentals_mid_0001	The enemy advance! Ready your forces for battle!	false
scripted_subtitles_localised_text_wh3_mom_intro_altar_of_ultimate_darkness_01	Ultimate Darkness awaits you, challenger.	false
scripted_subtitles_localised_text_wh3_mom_intro_altar_of_ultimate_darkness_02	Tzeentch manifests this ancient altar of Chaos so renowned on the mortal plane.	false
scripted_subtitles_localised_text_wh3_mom_intro_altar_of_ultimate_darkness_03	An insurmountable battle this may be, but far from a futile endeavour.	false
scripted_subtitles_localised_text_wh3_mom_intro_altar_of_ultimate_darkness_04	For this beacon of power grants great abilities – wield them and prove yourself!	false
scripted_subtitles_localised_text_wh3_mom_intro_black_fire_pass_01	Behold “Black Fire Pass”, legendary crucible of battle.	false
scripted_subtitles_localised_text_wh3_mom_intro_black_fire_pass_02	Recreated by the Changer of Ways for His own twisted enjoyment.	false
scripted_subtitles_localised_text_wh3_mom_intro_black_fire_pass_03	Though He gifts you powerful abilities, death is inevitable here.	false
scripted_subtitles_localised_text_wh3_mom_intro_black_fire_pass_04	Beneath His gaze you will be measured not by victory, but by the slaughter you wreak!	false
scripted_subtitles_localised_text_wh3_mom_intro_fallen_gates_01	Prepare yourself, Princeling, to indulge in Tzeentch’s mockery of the Fallen Gates.	false
scripted_subtitles_localised_text_wh3_mom_intro_fallen_gates_02	His powerful conjurations grant special powers in this place, but also certain death.	false
scripted_subtitles_localised_text_wh3_mom_intro_fallen_gates_03	Slaughter shall bring recognition; recognition shall bring reward.	false
scripted_subtitles_localised_text_wh3_mom_intro_fallen_gates_04	The Children of the Old Ones await you in battle!	false
scripted_subtitles_localised_text_wh3_mom_intro_hel_fenn_01	Welcome to “Hel Fenn”, Daemon Prince.	false
scripted_subtitles_localised_text_wh3_mom_intro_hel_fenn_02	Tzeentch manifests this cursed haunt in His realm, but with a twist.	false
scripted_subtitles_localised_text_wh3_mom_intro_hel_fenn_03	Though his gaze grants you power, there is no victory to be had here – only validation.	false
scripted_subtitles_localised_text_wh3_mom_intro_hel_fenn_04	Use the abilities bestowed upon you and revel in slaughter!	false
scripted_subtitles_localised_text_wh3_mom_intro_realm_of_tzeentch_01	How the God of Magic delights in His own playground of war!	false
scripted_subtitles_localised_text_wh3_mom_intro_realm_of_tzeentch_02	Where the laws of reality are twisted by His inscrutable whims.	false
scripted_subtitles_localised_text_wh3_mom_intro_realm_of_tzeentch_03	Here you will be pitted against the greatest Lord of Change of all, whose host will be unending.	false
scripted_subtitles_localised_text_wh3_mom_intro_realm_of_tzeentch_04	The power of Tzeentch is yours – but will His rewards be too?	false
scripted_subtitles_localised_text_wh3_scenario_01_prologue_intro_01	The journey has been long, but we are ready.	false
scripted_subtitles_localised_text_wh3_scenario_01_prologue_intro_02	Fellow Ungols, we are of Kislev – show these cowardly dogs what that means. They hunger for blood, let them taste cold steel!	false
scripted_subtitles_localised_text_wh3_scenario_01_prologue_urson_01	Yuri, hear me... as my paragon, I pass my strength on to you. Speak with my voice. Let the traitors hear you roar! 	false
scripted_subtitles_localised_text_wh_dlc01_qb_chs_archaon_armour_of_morkar_stage_3_pt_01	This fool dares challenge me?! He thinks I care about his trivial lust for power? 	false
scripted_subtitles_localised_text_wh_dlc01_qb_chs_archaon_armour_of_morkar_stage_3_pt_02	I will teach him a bitter lesson - one for all who defy me, who dare to oppose the will of the Chaos Gods! 	false
scripted_subtitles_localised_text_wh_dlc01_qb_chs_archaon_armour_of_morkar_stage_3_pt_03	Here is a maggot to make an example of! It will be a warning to all the Chieftains of the North.	false
scripted_subtitles_localised_text_wh_dlc01_qb_chs_archaon_armour_of_morkar_stage_3_pt_04	Now, my followers, let us attend this tiresomeness - by dusk I wish to be swilling the maggot’s blood in his upturned skull, while channelling his ravaged spirit into Morkar’s armour!   	false
scripted_subtitles_localised_text_wh_dlc01_qb_chs_archaon_crown_of_domination_stage_2_pt_01	Even as this Daemon-spawn plots to overthrow me, I know my destiny is absolute. Be’lakor will coronate me! 	false
scripted_subtitles_localised_text_wh_dlc01_qb_chs_archaon_crown_of_domination_stage_2_pt_02	Come then, Changer, bring your best! I will prove once more that I am the Everchosen…	false
scripted_subtitles_localised_text_wh_dlc01_qb_chs_archaon_crown_of_domination_stage_2_pt_03	For I am the Anointed, the Bringer of Woes - the one, true, LORD OF CHAOS! 	false
scripted_subtitles_localised_text_wh_dlc01_qb_chs_archaon_eye_of_sheerian_stage_3_pt_01	At last! A worthy challenger comes! 	false
scripted_subtitles_localised_text_wh_dlc01_qb_chs_archaon_eye_of_sheerian_stage_3_pt_02	Not some weak minion sent by the Gods. No, what confronts me is something more corrupt, more bestial. It serves no master, seeks no glory other than its own! And that I applaud… even as I rip at its throats. For it must die. No man, no God… no creature, can challenge me and live!  	false
scripted_subtitles_localised_text_wh_dlc01_qb_chs_archaon_slayer_of_kings_stage_3_pt_01	Another thinks to bring me to my knees! Another who wishes me to bow before him, like he is some pitiless king! 	false
scripted_subtitles_localised_text_wh_dlc01_qb_chs_archaon_slayer_of_kings_stage_3_pt_02	Does he think his pathetic sorceries will work on me or my followers? 	false
scripted_subtitles_localised_text_wh_dlc01_qb_chs_archaon_slayer_of_kings_stage_3_pt_03	Come, my swords of Chaos, let us show this weakling conjurer who-would-be-royalty what I do to monarchs! He will see why I am the Lord of the End Times, why I am Everchosen, and why I will wield the Slayer of Kings! 	false
scripted_subtitles_localised_text_wh_dlc01_qb_chs_kholek_suneater_starcrusher_stage_3_pt_01	The green things and Unliving alike will bear witness to my wrath! They are mine to dismember, to disembowel, to crush! 	false
scripted_subtitles_localised_text_wh_dlc01_qb_chs_kholek_suneater_starcrusher_stage_3_pt_02	I will smash all that remains of these ruins to powder and not stop until my hammer is found. 	false
scripted_subtitles_localised_text_wh_dlc01_qb_chs_kholek_suneater_starcrusher_stage_3_pt_03	And then the whole world will burn before I rest again - such is my rage - this is the new pact I make to the Dark Powers!  Raaaaargh! 	false
scripted_subtitles_localised_text_wh_dlc01_qb_chs_prince_sigvald_auric_armour_stage_3_pt_01	Ah, my loyal minions. Over the way stands something I want… I need. Beatific mail, wasted on the clueless worm who wears it. 	false
scripted_subtitles_localised_text_wh_dlc01_qb_chs_prince_sigvald_auric_armour_stage_3_pt_02	It is only right I take it from him, and if you, my serfs, die in agony during the attempt, then know that I'll feel your pain… why, I will relish it! 	false
scripted_subtitles_localised_text_wh_dlc01_qb_chs_prince_sigvald_auric_armour_stage_3_pt_03	To the ‘champion’ in my armour… Yes, you may have heard of me. I am Sigvald the Magnificent, the Geld-Prince of Slaanesh. I do not blame you if hearing my name has caused you to void your bowels. Just make sure the Auric Armour is clean when I come to take it.	false
scripted_subtitles_localised_text_wh_dlc01_qb_chs_prince_sigvald_auric_armour_stage_3_pt_04	You could hand it straight over, of course, but I have seen your kind before. You will be irksome and make me fight for it. 	false
scripted_subtitles_localised_text_wh_dlc01_qb_chs_prince_sigvald_auric_armour_stage_3_pt_05	No Matter! I could do with a workout - but do not over-vex me or your death-cry will be especially shrill and I do hate to taint my ears with such cacophonic nonsense if I can bear it. 	false
scripted_subtitles_localised_text_wh_dlc01_qb_chs_prince_sigvald_sliverslash_stage_4_pt_01	Sickly, sinful, spectacles stand, shuffle, shamble and saunter shamelessly in mine scandalized sight! I suggest a solution... 	false
scripted_subtitles_localised_text_wh_dlc01_qb_chs_prince_sigvald_sliverslash_stage_4_pt_02	Surely such sedition should sour and succumb to Sigvald - the salacious, scandalous and sensational servant of Slaanesh! Son of Succubi, scion of sordid acts and slayer of squalid serfs! 	false
scripted_subtitles_localised_text_wh_dlc01_qb_chs_prince_sigvald_sliverslash_stage_4_pt_03	See how I stroll, stride, swagger and swirl, spin, slash and stab at stupid, senseless scum! Soon they shall swoon, shall seek solace and death from sundry torments wrought on them by my strategic, severing, scintillating shower of shimmering strikes!	false
scripted_subtitles_localised_text_wh_dlc01_qb_chs_prince_sigvald_sliverslash_stage_4_pt_04	Send for the sword - summon Sliverslash! 	false
scripted_subtitles_localised_text_wh_dlc03_qb_bst_Morghur_battle_spirit_chaos_pt_01	Puny Elf! Uncloven. Unknowing. Ignorant.	false
scripted_subtitles_localised_text_wh_dlc03_qb_bst_Morghur_battle_spirit_chaos_pt_02	They take from me what is mine - weapon. Power! 	false
scripted_subtitles_localised_text_wh_dlc03_qb_bst_Morghur_battle_spirit_chaos_pt_03	They will regret. Morghur will change them; ruin them.	false
scripted_subtitles_localised_text_wh_dlc03_qb_bst_Morghur_battle_spirit_chaos_pt_04	They will know our power, MY power! Raaarrr!	false
scripted_subtitles_localised_text_wh_dlc03_qb_bst_khazrak_dark_mail_stage_5_pt_01	Graktar is lame… grrr… his time is over! Put him in ground, let him feed worms! Now is the time of Khazrak! They call me cunning, they call me the One-Eye - I call me Beastlord of all! RRRRRRAAAAARRRR!!!! 	false
scripted_subtitles_localised_text_wh_dlc03_qb_bst_khazrak_one_eye_scourge_stage_4_slaughter_at_grimminhagen_pt_01	Take them now! 	false
scripted_subtitles_localised_text_wh_dlc03_qb_bst_khazrak_one_eye_scourge_stage_4_slaughter_at_grimminhagen_pt_02	Bathe in their blood – feast on their guts – gnaw on their bones! 	false
scripted_subtitles_localised_text_wh_dlc03_qb_bst_khazrak_one_eye_scourge_stage_4_slaughter_at_grimminhagen_pt_03	Let their puny wolf god know that it is the One-Eye who slaughters his pack!	false
scripted_subtitles_localised_text_wh_dlc03_qb_bst_khazrak_one_eye_the_dark_mail_stage_5_ashes_of_kelp_and_koldust_pt_01	Graktar is lame. His time is over!	false
scripted_subtitles_localised_text_wh_dlc03_qb_bst_khazrak_one_eye_the_dark_mail_stage_5_ashes_of_kelp_and_koldust_pt_02	Put him in ground, let him feed worms! Now is the time of Khazrak!	false
scripted_subtitles_localised_text_wh_dlc03_qb_bst_khazrak_one_eye_the_dark_mail_stage_5_ashes_of_kelp_and_koldust_pt_03	They call me cunning, they call me the One-Eye - I call me Beastlord of all!	false
scripted_subtitles_localised_text_wh_dlc03_qb_bst_khazrak_scourge_stage_5_pt_01	RRRRRRAAAARRRRR! Take them now! Bathe in their blood – feast on their guts – gnaw on their bones! Let their puny wolf god know that it is the One-Eye who slaughters his pack! RRRRRRAAAAARRRR!!!! 	false
scripted_subtitles_localised_text_wh_dlc03_qb_bst_khazrak_the_fall_of_man_pt_01	See craven men! See them limp together like scared cattle… grr… They run no more; now is slaughter! Now we end lake hag's mongrels; now we end Sigmar's weak sons... grr... Kill for me, kill for dark masters, kill! That is why we were born! KILL!	false
scripted_subtitles_localised_text_wh_dlc03_qb_bst_malagor_icons_of_vilification_stage_7_pt_01	I have seen it, my herd-kin! The Dark Masters, show me the way… grrrr… tear down their walls, burn their churches… grrrr… defile this river with man-filth bodies! Grrr… please me - your Crowfather - and let the Dark Omen spread… GRRRRRR! 	false
scripted_subtitles_localised_text_wh_dlc03_qb_bst_malagor_the_dark_omen_the_icons_of_vilification_stage_6_the_stir_river_pt_01	I have seen it, my herd-kin!	false
scripted_subtitles_localised_text_wh_dlc03_qb_bst_malagor_the_dark_omen_the_icons_of_vilification_stage_6_the_stir_river_pt_02	The Dark Masters, show me the way. Tear down their walls, burn their churches… 	false
scripted_subtitles_localised_text_wh_dlc03_qb_bst_malagor_the_dark_omen_the_icons_of_vilification_stage_6_the_stir_river_pt_03	Defile this river with man-filth bodies!	false
scripted_subtitles_localised_text_wh_dlc03_qb_bst_malagor_the_dark_omen_the_icons_of_vilification_stage_6_the_stir_river_pt_04	Please me - your Crowfather - and let the Dark Omen spread!	false
scripted_subtitles_localised_text_wh_dlc03_qb_bst_the_final_battle_pt_01	See craven men! See them limp together like scared cattle.	false
scripted_subtitles_localised_text_wh_dlc03_qb_bst_the_final_battle_pt_02	They run no more; now is slaughter! Now we end lake hag's mongrels; now we end Sigmar's weak sons.	false
scripted_subtitles_localised_text_wh_dlc03_qb_bst_the_final_battle_pt_03	Kill for me, kill for dark masters, kill! That is why we were born! KILL!  	false
scripted_subtitles_localised_text_wh_dlc04_qb_emp_volkmar_the_grim_jade_griffon_stage_5_pt_01	Sons of Sigmar, to me! Out there in that fen is a heretic, holding the Jade Griffon to his chest like the grubby thief he is! 	false
scripted_subtitles_localised_text_wh_dlc04_qb_emp_volkmar_the_grim_jade_griffon_stage_5_pt_02	To think that the talisman - a symbol of our Cult blessed by Magnus himself - is now in the clutches of this Necromancer and his Vampire consorts!	false
scripted_subtitles_localised_text_wh_dlc04_qb_emp_volkmar_the_grim_jade_griffon_stage_5_pt_03	No! I say again, NO! Hunt down this filth, purge this place, and strike down any who dare to rise again - by the comet, that is my decree!	false
scripted_subtitles_localised_text_wh_dlc04_qb_emp_volkmar_the_grim_staff_of_command_stage_6_pt_01	The Cult of Ulric has defamed us! The Midden-Wolves should be our allies, for was Sigmar not a worshipper of Ulric during his mortal span? 	false
scripted_subtitles_localised_text_wh_dlc04_qb_emp_volkmar_the_grim_staff_of_command_stage_6_pt_02	 Instead they work against us, weakening the Empire that our sovereign lord, Emperor Karl Franz, has laboured so hard to unite under the Twin-Tailed Comet's glowing aspect. 	false
scripted_subtitles_localised_text_wh_dlc04_qb_emp_volkmar_the_grim_staff_of_command_stage_6_pt_03	 I will have no more of this foolishness! Slay this representative of the Ar-Ulric, let that be chastisement enough, and then - if Sigmar permits - we may become brothers-in-arms once more. 	false
scripted_subtitles_localised_text_wh_dlc04_qb_emp_volkmar_the_grim_staff_of_command_stage_6_pt_04	Now we must fight this sorry battle, not for my honour but for that of Sigmar himself! To war! 	false
scripted_subtitles_localised_text_wh_dlc04_qb_vmp_helman_ghorst_liber_noctus_stage_6_pt_01	Not long, my brothers. Soon I shall have the missing pages and with the Liber Noctus complete I can begin your true resurrection! 	false
scripted_subtitles_localised_text_wh_dlc04_qb_vmp_helman_ghorst_liber_noctus_stage_6_pt_02	Mannfred may have set this task as a test, but I fear no challenge. 	false
scripted_subtitles_localised_text_wh_dlc04_qb_vmp_helman_ghorst_liber_noctus_stage_6_pt_03	Now, go my minions - onwards! Take these living fools by surprise. I'll have that casket and the pages within!	false
scripted_subtitles_localised_text_wh_dlc04_qb_vmp_vlad_von_carstein_blood_drinker_stage_4_pt_01	I have not seen such a pathetic sight since mine father-in-law, Otto, took his last breath! Is this all that thine Empire can muster?	false
scripted_subtitles_localised_text_wh_dlc04_qb_vmp_vlad_von_carstein_blood_drinker_stage_4_pt_02	What a pitiful age this is! It makes me pander for the era of worthy foes, such as Wilhelm, or that Wolf Knight, Kruger... not this pathetic squabble of mortal men.	false
scripted_subtitles_localised_text_wh_dlc04_qb_vmp_vlad_von_carstein_blood_drinker_stage_4_pt_03	Yet my sword thirsts and so it shall be slaked in the blood of living fools that think to challenge the might of von Carstein. Let the slaughter begin!	false
scripted_subtitles_localised_text_wh_dlc04_qb_vmp_vlad_von_carstein_the_carstein_ring_stage_5_pt_01	Mine puppets, do me this deed. Purge the area of insects so thy master can collect this Warpstone unchallenged.	false
scripted_subtitles_localised_text_wh_dlc04_qb_vmp_vlad_von_carstein_the_carstein_ring_stage_5_pt_02	If mine memory serves, I sought out such material in Mordheim some centuries ago.	false
scripted_subtitles_localised_text_wh_dlc04_qb_vmp_vlad_von_carstein_the_carstein_ring_stage_5_pt_03	They were halcyon days - when my minions hunted wyrdstone and the Empire was in ruins, as it will be again...	false
scripted_subtitles_localised_text_wh_dlc04_qb_vmp_vlad_von_carstein_the_carstein_ring_stage_5_pt_04	Fetch me the head of this Strigoi - I would have this nuisance quashed!	false
scripted_subtitles_localised_text_wh_dlc05_qb_wef_durthu_daiths_sword_stage_4_pt_01	All has happened before. All will happen again. Suffering is unending - battle, eternal.	false
scripted_subtitles_localised_text_wh_dlc05_qb_wef_durthu_daiths_sword_stage_4_pt_02	The only answer is in kind; I will rise and smite the Undead outsiders. 	false
scripted_subtitles_localised_text_wh_dlc05_qb_wef_durthu_daiths_sword_stage_4_pt_03	Return to me the battle-gift of Daith that I might enact wrath upon the world!	false
scripted_subtitles_localised_text_wh_dlc05_qb_wef_orion_cloak_of_isha_pt_01	This naive and foolish Glade Lord has allowed his mind to be poisoned by the Prince of Pleasure.	false
scripted_subtitles_localised_text_wh_dlc05_qb_wef_orion_cloak_of_isha_pt_02	The Dreaming Woods are a forbidden place of great malice and deception, and in his folly our erstwhile brother has been twisted by the dark deeds within. 	false
scripted_subtitles_localised_text_wh_dlc05_qb_wef_orion_cloak_of_isha_pt_03	There can be no further mercy. As I am born from Kurnous' spirit, so shall these dark servants be purged by it. 	false
scripted_subtitles_localised_text_wh_dlc05_qb_wef_orion_cloak_of_isha_pt_04	Let them face the rage of the forest!	false
scripted_subtitles_localised_text_wh_dlc05_qb_wef_orion_horn_of_the_wild_hunt_pt_01	These beasts call themselves 'hunters'? Hah! Do they not know they face Orion, Master of the Wild Hunt? 	false
scripted_subtitles_localised_text_wh_dlc05_qb_wef_orion_horn_of_the_wild_hunt_pt_02	 Their auras cannot protect them now, for I am charged with the spirit of Kurnous; rage and destruction flow through me! 	false
scripted_subtitles_localised_text_wh_dlc05_qb_wef_orion_horn_of_the_wild_hunt_pt_03	Fall upon them as the howling winds fall upon the winter leaves - show them that nothing can stand before the fury of the storm!	false
scripted_subtitles_localised_text_wh_dlc05_qb_wef_orion_spear_of_kurnous_pt_01	The seasons move ever on, and I feel the call to the Oak of Ages. Before I return to Ariel's embrace, another must be chosen to be born anew. 	false
scripted_subtitles_localised_text_wh_dlc05_qb_wef_orion_spear_of_kurnous_pt_02	Yet these traitors would sully the forest and bear a corrupt vision into being through their blackened hearts. These curs cannot be suffered to live. 	false
scripted_subtitles_localised_text_wh_dlc05_qb_wef_orion_spear_of_kurnous_pt_03	Though we challenge Anath Raema herself, the will of Kurnous must spurn her once more, and overcome these perverse desires!	false
scripted_subtitles_localised_text_wh_dlc06_qb_dwf_belegar_ironhammer_hammer_of_anground_stage_4_pt_01	The lost vault of Angrund is within reach!	false
scripted_subtitles_localised_text_wh_dlc06_qb_dwf_belegar_ironhammer_hammer_of_anground_stage_4_pt_02	Are we going to let these urk trespassers get away with their sneaky shenanigans? Do we let them steal the treasure and valuables which belong to the Angrund Clan by right? 	false
scripted_subtitles_localised_text_wh_dlc06_qb_dwf_belegar_ironhammer_hammer_of_anground_stage_4_pt_03	No! We do not! Let the grudge be settled - let vengeance begin! Yaaaarh!	false
scripted_subtitles_localised_text_wh_dlc06_qb_dwf_belegar_ironhammer_shield_of_defiance_stage_3_pt_01	Yes, my kin, today is a great day! Today we kill urks! Today is vengeance! 	false
scripted_subtitles_localised_text_wh_dlc06_qb_dwf_belegar_ironhammer_shield_of_defiance_stage_3_pt_02	Even now a throng from Karak Azul approaches the green-filth from the rear. 	false
scripted_subtitles_localised_text_wh_dlc06_qb_dwf_belegar_ironhammer_shield_of_defiance_stage_3_pt_03	We are honoured to dreng the Orcs from the front - let them face our might, let them see what Dawi of the Angrund Clan are made of!	false
scripted_subtitles_localised_text_wh_dlc06_qb_grn_skarsnik_skarsniks_prodder_stage_5_pt_01	So predickable, dese stunties act like clockworkz. I bet I could work out when Ironhammer or Grudgebearer comb deir beardz if I wanted... 	false
scripted_subtitles_localised_text_wh_dlc06_qb_grn_skarsnik_skarsniks_prodder_stage_5_pt_02	So, 'ere's da plan, take 'em in da front and in da sidez. I want da way clear'd so I can get my new prodder! Geddit?	false
scripted_subtitles_localised_text_wh_dlc06_qb_grn_skarsnik_skarsniks_prodder_stage_5_pt_03	If I see any of yoo runnin' da wrong way... well Gobbla 'ere iz' 'ungry - ee's alwayz 'ungry!	false
scripted_subtitles_localised_text_wh_dlc06_qb_grn_wurrzag_da_great_green_prophet_baleful_mask_stage_4_pt_01	Dis false prophet don't talk to da Green Godz. I should know cos dey told me, dey don't like 'im! Ee smellz right funny. 'Ee got some crazy funk about 'im alright. 	false
scripted_subtitles_localised_text_wh_dlc06_qb_grn_wurrzag_da_great_green_prophet_baleful_mask_stage_4_pt_02	Go and kill da git and all 'iz mates. And get my mask back off 'im...	false
scripted_subtitles_localised_text_wh_dlc06_qb_grn_wurrzag_da_great_green_prophet_baleful_mask_stage_4_pt_03	...dey nicked it and I want it back! 	false
scripted_subtitles_localised_text_wh_dlc06_qb_grn_wurrzag_da_great_green_prophet_bonewood_staff_stage_4_pt_01	Black Fire Pass - it's all burnt, just 'ow I like my battlefieldz. 	false
scripted_subtitles_localised_text_wh_dlc06_qb_grn_wurrzag_da_great_green_prophet_bonewood_staff_stage_4_pt_02	Gork want uz to fight da humies 'ere. Sez if we do dat and smack 'em about real good, den 'ee'll power up ma staff. 	false
scripted_subtitles_localised_text_wh_dlc06_qb_grn_wurrzag_da_great_green_prophet_bonewood_staff_stage_4_pt_03	So listen to ya mate, Wurrzag - I'm da prophet and wot I sez goes! Let'z get 'em!	false
scripted_subtitles_localised_text_wh_dlc06_qb_grn_wurrzag_da_great_green_prophet_squiggly_beast_stage_4_pt_01	Um chuuka arrr, um chuuka arr, um chuuka ar Wurrzag Ud Ura Zahubu!	false
scripted_subtitles_localised_text_wh_dlc06_qb_grn_wurrzag_da_great_green_prophet_squiggly_beast_stage_4_pt_02	Right, dats Gork and Mork up-ta-date! And they're as miffed as me at dose gits stealin' my Squiggly Beast! 	false
scripted_subtitles_localised_text_wh_dlc06_qb_grn_wurrzag_da_great_green_prophet_squiggly_beast_stage_4_pt_03	We gotta go and teach 'em a lesson; teach 'em not ta mess wiv Da Great Green Prophet! WAAAGH!	false
scripted_subtitles_localised_text_wh_dlc07_qb_brt_alberic_trident_of_manann_pt_01	My friends; we are blighted by savage deception from those we once thought of as brothers! They have stolen the artefacts from beneath us and now they mock our righteous fury!	false
scripted_subtitles_localised_text_wh_dlc07_qb_brt_alberic_trident_of_manann_pt_02	We will not yield to these curs, no! We will plunge our blades into their ignoble hearts and reclaim our birthright!	false
scripted_subtitles_localised_text_wh_dlc07_qb_brt_alberic_trident_of_manann_pt_03	Much like the sea crashing against the shore, we will crush these traitors. Now, with me, Companions; for Bordeleaux!	false
scripted_subtitles_localised_text_wh_dlc07_qb_brt_fay_enchantress_chalice_of_potions_pt_01	It is a great deed we must do today. The twisted things of Chaos have come to our shores in vast numbers. Many were dashed upon the rocks, yet enough remain to pose a terrible threat. 	false
scripted_subtitles_localised_text_wh_dlc07_qb_brt_fay_enchantress_chalice_of_potions_pt_02	Malice seeps from their every pore and breath - they are the very essence of doom.	false
scripted_subtitles_localised_text_wh_dlc07_qb_brt_fay_enchantress_chalice_of_potions_pt_03	Should they win this day, Bretonnia will be nought but ruins. But hope endures; take solace in the Lady’s shining grace - for victory!	false
scripted_subtitles_localised_text_wh_dlc07_qb_brt_louen_sword_of_couronne_pt_01	Companions - Bretonnia's need is dire! This terrible fog corrodes our focus. Our enemy, a horde of horrifying beasts, thrives in this gloom, so be on your guard.	false
scripted_subtitles_localised_text_wh_dlc07_qb_brt_louen_sword_of_couronne_pt_02	A head-on charge may not succeed - we must proceed more carefully. They are fast and deceptively cunning, but you are the Lady’s men, and no beast will stop you.	false
scripted_subtitles_localised_text_wh_dlc07_qb_brt_louen_sword_of_couronne_pt_03	Should we fail today, Bretonnia will be left vulnerable. The kingdom relies on us; so fight to defend all you hold dear!	false
scripted_subtitles_localised_text_wh_main_prelude_grimgor_ironhide_pt_01	Right, yoo gitz! Fink you can hide from me in dere! Dis fortress iz now mine!	false
scripted_subtitles_localised_text_wh_main_prelude_grimgor_ironhide_pt_02	I'm 'da Greatest' not som stinking goblin-lovin' git called Rotgut! Immortulz ta me - let'z get ‘em!!!	false
scripted_subtitles_localised_text_wh_main_prelude_karl_franz_pt_01	Men of Reikland! Greenskins assault our capital. Theirs is a vile race Sigmar swore to expel from our lands, yet they dare return!	false
scripted_subtitles_localised_text_wh_main_prelude_karl_franz_pt_02	Join me, men - for I will not rest until every accursed Goblin lies burning on a pyre!	false
scripted_subtitles_localised_text_wh_main_prelude_mannfred_von_carstein_pt_01	Feeble Liche - come hence from mine fortress and kneel before thy Lord!	false
scripted_subtitles_localised_text_wh_main_prelude_mannfred_von_carstein_pt_02	Drakenhof's stones are bound by mortar of mine own blood. While yours shall be sprayed across the battlefield as I wrench the head from thine shoulders!	false
scripted_subtitles_localised_text_wh_main_prelude_thorgrim_grudgebearer_pt_01	Fellow Dawi, I see Orc scum! They foul our mountains with their vile taint.	false
scripted_subtitles_localised_text_wh_main_prelude_thorgrim_grudgebearer_pt_02	The Dammaz Kron, our Great Book of Grudges, is filled with such Greenskin atrocities! Bring hammer and axe - show these urks and grobi no mercy!	false
scripted_subtitles_localised_text_wh_main_qb_dwf_thorgrim_grudgebearer_armour_of_skaldour_stage_4_pt_01	It is time for a cull, my kin, the creatures of Troll Country are nowt but a nuisance - a menace to be laid low! 	false
scripted_subtitles_localised_text_wh_main_qb_dwf_thorgrim_grudgebearer_armour_of_skaldour_stage_4_pt_02	To the Slayers, I say, chant your battle-hymns of doom, fulfil your oaths and seek glory in death! 	false
scripted_subtitles_localised_text_wh_main_qb_dwf_thorgrim_grudgebearer_armour_of_skaldour_stage_4_pt_03	To the rest of the throng: I have studied the pages of the Dammaz Kron and found many, many entries of Trolls, Giants and other fell things attacking Dwarfen families, stealing our treasures, and destroying our holds! 	false
scripted_subtitles_localised_text_wh_main_qb_dwf_thorgrim_grudgebearer_armour_of_skaldour_stage_4_pt_04	These creatures are descendants of those perpetrators and the debt stands with them.	false
scripted_subtitles_localised_text_wh_main_qb_dwf_thorgrim_grudgebearer_armour_of_skaldour_stage_4_pt_05	Destroy these monsters, bring them down like rotten elgi trees, so we may raid their filthy lairs and reclaim lost heirlooms that belong in Karaz-a-Karak! 	false
scripted_subtitles_localised_text_wh_main_qb_dwf_thorgrim_grudgebearer_armour_of_skaldour_stage_4_pt_06	This is my edict as High King! Khazukan Kazakit-ha!	false
scripted_subtitles_localised_text_wh_main_qb_dwf_thorgrim_grudgebearer_axe_of_grimnir_stage_3_01	Behold, the stone-fruits of the Engineers' Guild's labour! 	false
scripted_subtitles_localised_text_wh_main_qb_dwf_thorgrim_grudgebearer_axe_of_grimnir_stage_3_02	New flying Gyro-machines will take to the air!	false
scripted_subtitles_localised_text_wh_main_qb_dwf_thorgrim_grudgebearer_axe_of_grimnir_stage_3_03	Let me assure my traditionalist brethren within the Guild that Morgrim himself would be pleased with this innovation. 	false
scripted_subtitles_localised_text_wh_main_qb_dwf_thorgrim_grudgebearer_axe_of_grimnir_stage_3_04	Now let us test them against the eternal enemy - the ones who have more entries in the Great Book of Grudges than any other - the Orcs!  	false
scripted_subtitles_localised_text_wh_main_qb_dwf_thorgrim_grudgebearer_axe_of_grimnir_stage_3_05	See how the Greenskin filth flock around that vile pillar! Let us wipe them out!	false
scripted_subtitles_localised_text_wh_main_qb_dwf_thorgrim_grudgebearer_axe_of_grimnir_stage_3_06	So confident am I in these new machines that I forsake my axe, and will not take it up again until victory is secured here.	false
scripted_subtitles_localised_text_wh_main_qb_dwf_thorgrim_grudgebearer_axe_of_grimnir_stage_3_07	I do this in the knowledge that those Orcs will soon be corpses scattering the battlefield. Let us be about this! 	false
scripted_subtitles_localised_text_wh_main_qb_dwf_thorgrim_grudgebearer_axe_of_grimnir_stage_3_pt_01	Behold! The stone-fruits of the Engineers' Guild's labour - new flying Gyro-machines will take to the air! 	false
scripted_subtitles_localised_text_wh_main_qb_dwf_thorgrim_grudgebearer_axe_of_grimnir_stage_3_pt_02	Let me assure my traditionalist brethren within the Guild, that Morgrim himself would be pleased with this innovation. 	false
scripted_subtitles_localised_text_wh_main_qb_dwf_thorgrim_grudgebearer_axe_of_grimnir_stage_3_pt_03	Now let us test them against the eternal enemy - the ones who have more entries in the Great Book of Grudges than any other - the Orcs!  	false
scripted_subtitles_localised_text_wh_main_qb_dwf_thorgrim_grudgebearer_axe_of_grimnir_stage_3_pt_04	See how the Greenskin filth flock around that vile pillar! Let us wipe them out, so confident am I in these new machines that I forsake my axe, and will not take it up again until victory is secured here. 	false
scripted_subtitles_localised_text_wh_main_qb_dwf_thorgrim_grudgebearer_axe_of_grimnir_stage_3_pt_05	I do this in the knowledge that those Orcs will soon be corpses scattering the battlefield. 	false
scripted_subtitles_localised_text_wh_main_qb_dwf_thorgrim_grudgebearer_axe_of_grimnir_stage_3_pt_06	Let us be about this! 	false
scripted_subtitles_localised_text_wh_main_qb_dwf_thorgrim_grudgebearer_book_of_grudges_stage_3_pt_01	We come to Hel Fenn – this foetid realm – to enact vengeance! A great wrong has befallen our kin, innocent Clans-Dwarfs on a trade mission have been butchered by the Uzkular! 	false
scripted_subtitles_localised_text_wh_main_qb_dwf_thorgrim_grudgebearer_book_of_grudges_stage_3_pt_02	This fell deed has been entered into the Dammaz Kron and the cover slammed shut in rage! By my oath it shall not be opened until the grudge is settled, until the bones of the Undead are smashed to powder! 	false
scripted_subtitles_localised_text_wh_main_qb_dwf_thorgrim_grudgebearer_book_of_grudges_stage_3_pt_03	Now, Dawi, take up your axes, for the Undead will come to face us. They must, or I’ll have every tomb, every cursed gravesite, scoured from these lands, leaving these fell vampires with no puppets to command… 	false
scripted_subtitles_localised_text_wh_main_qb_dwf_thorgrim_grudgebearer_book_of_grudges_stage_3_pt_04	Come then, Zangunaz - raise your minions, march them forth for the High King of the Karaz Ankor would have his vengeance on you all! 	false
scripted_subtitles_localised_text_wh_main_qb_dwf_thorgrim_grudgebearer_dragon_crown_of_karaz_stage_3_pt_01	Once more we will ally with the Manlings, just as Grimnir did ten-score centuries ago! It has been many years since the umgi have produced an emperor as worthy as Magnus or their founding warrior-king, but… I hear good things about this Franz. 	false
scripted_subtitles_localised_text_wh_main_qb_dwf_thorgrim_grudgebearer_dragon_crown_of_karaz_stage_3_pt_02	Now is the time to test his mettle, we will stand with him against the grobi at Black Fire Pass as King Kurgan did long ago. 	false
scripted_subtitles_localised_text_wh_main_qb_dwf_thorgrim_grudgebearer_dragon_crown_of_karaz_stage_3_pt_03	If the men of the Empire fight with bravery and honour then the runes of my crown will glow with pride ever after, a gesture of my will - just as this Emperor awaits to take up his Warhammer – a gift from the Dwarfs no less… 	false
scripted_subtitles_localised_text_wh_main_qb_dwf_thorgrim_grudgebearer_dragon_crown_of_karaz_stage_3_pt_04	So, gird your loins, my kin. May your az be sharp and thirsty for urk blood, for they come. 	false
scripted_subtitles_localised_text_wh_main_qb_dwf_thorgrim_grudgebearer_dragon_crown_of_karaz_stage_3_pt_05	We will repulse these vile creatures with our dying breath and renew the oldest and greatest alliance this world has ever seen! 	false
scripted_subtitles_localised_text_wh_main_qb_dwf_thorgrim_grudgebearer_intro_subterranean_pt_01	March on, brave Dawi, march on! 	false
scripted_subtitles_localised_text_wh_main_qb_dwf_thorgrim_grudgebearer_intro_subterranean_pt_02	To the cursed realms of the grobi we go. I know not what mischief they cause, but they are up to something for my beard itches with trouble!	false
scripted_subtitles_localised_text_wh_main_qb_dwf_thorgrim_grudgebearer_intro_subterranean_pt_02a	We take the Underway, these ancient highways built by Dwarf hands give us the best chance of approaching swiftly - catching the Greenskins unawares…	false
scripted_subtitles_localised_text_wh_main_qb_dwf_thorgrim_grudgebearer_intro_subterranean_pt_03	So let us not dawdle, for there are grudges to settle and new entries in the Dammaz Kron to write! 	false
scripted_subtitles_localised_text_wh_main_qb_dwf_ungrim_ironfist_axe_of_dargo_stage_4_pt_01	There… there, across the way… the discordance. For the Axe of Dargo to sing again, for the runes to glow bright with power once more, we must destroy the foe before us - the Chaos filth that dare cross our mountains! 	false
scripted_subtitles_localised_text_wh_main_qb_dwf_ungrim_ironfist_axe_of_dargo_stage_4_pt_02	We do this in the name of Grimnir. For it will be a joy to spill the blood of Northmen. 	false
scripted_subtitles_localised_text_wh_main_qb_dwf_ungrim_ironfist_axe_of_dargo_stage_4_pt_03	The enemy Lord is a taint upon the world, yet in fighting him I shall make a thing of wondrous beauty. A perfect song of weaponcraft in whose rhythm the axe of my ancestor shall find harmony anew. 	false
scripted_subtitles_localised_text_wh_main_qb_dwf_ungrim_ironfist_axe_of_dargo_stage_4_pt_04	Slayers - I hear your howls of longing, desperate to be about this, to plunge your axes into the Chaos scum before us. So, go - bring me victory, bring me death!  	false
scripted_subtitles_localised_text_wh_main_qb_dwf_ungrim_ironfist_dragon_cloak_of_fyrskar_stage_4_pt_01	At last! Enough of this larking about, lads. It is time to arm ourselves, to act like Slayers and bring death to the urks - and especially those snivelling grobi! 	false
scripted_subtitles_localised_text_wh_main_qb_dwf_ungrim_ironfist_dragon_cloak_of_fyrskar_stage_4_pt_02	I wish to cleanse myself in battle, once I have cleaned my soul of the subterfuge then I will wear the honourable Cloak of Fyrskar again!	false
scripted_subtitles_localised_text_wh_main_qb_dwf_ungrim_ironfist_dragon_cloak_of_fyrskar_stage_4_pt_03	Now, my throng, ready your shield walls, bring the oath stones, let us dreng all before us! When the job is done I will crack open a barrel of Bugman’s and we will drink until none can stand! 	false
scripted_subtitles_localised_text_wh_main_qb_dwf_ungrim_ironfist_dragon_cloak_of_fyrskar_stage_4_pt_04	Are you with me, lads?!	false
scripted_subtitles_localised_text_wh_main_qb_dwf_ungrim_ironfist_slayer_crown_stage_5_pt_01	Slayers! I see before me the Zangunaz and its filthy minions. 	false
scripted_subtitles_localised_text_wh_main_qb_dwf_ungrim_ironfist_slayer_crown_stage_5_pt_02	Even now the vampire stands there, chanting filthy umgi spells, trying to summon some abomination. It is time to fulfil your oaths made in Karak Kadrin! 	false
scripted_subtitles_localised_text_wh_main_qb_dwf_ungrim_ironfist_slayer_crown_stage_5_pt_03	Slay everything that does not draw breath! And if some beast does get pulled back to life, then I relish meeting it in battle! 	false
scripted_subtitles_localised_text_wh_main_qb_dwf_ungrim_ironfist_slayer_crown_stage_5_pt_04	Now we move! Charge for the honour of all Kadrin! Charge for your King! Charge for the Slayer Crown! CHAAAARGE!	false
scripted_subtitles_localised_text_wh_main_qb_emp_balthasar_gelt_amulet_of_sea_gold_stage_4_1_pt_01	Welcome to Estalia, gentlemen. 	false
scripted_subtitles_localised_text_wh_main_qb_emp_balthasar_gelt_amulet_of_sea_gold_stage_4_1_pt_02	I will not lie, the chances of your survival are small – some may even turn against your friends as living corpses… But you have my word that I will use my arcane gifts to ensure your bodies are given unto Morr’s garden. 	false
scripted_subtitles_localised_text_wh_main_qb_emp_balthasar_gelt_amulet_of_sea_gold_stage_4_1_pt_03	This is the greatest reward, more than even gold for the fate of your soul is an eternal concern! 	false
scripted_subtitles_localised_text_wh_main_qb_emp_balthasar_gelt_amulet_of_sea_gold_stage_4_1_pt_04	Now, come. Follow me, strike down the Undead that rise against us, allow me to find this eldritch amulet. I ask not for my own selfish studies but for the good of the Empire! 	false
scripted_subtitles_localised_text_wh_main_qb_emp_balthasar_gelt_cloak_of_molten_metal_stage_5_pt_01	With me, followers - we will descend into Drake-Tooth Hollow, this cave of ill-aspect, for within lies an artefact of great power.	false
scripted_subtitles_localised_text_wh_main_qb_emp_balthasar_gelt_cloak_of_molten_metal_stage_5_pt_02	My arcane talents tell me this place is not unprotected, an ancient, once-dead guardian lies in wait. We must destroy it before we can collect the cave’s secrets. You will do this for me.	false
scripted_subtitles_localised_text_wh_main_qb_emp_balthasar_gelt_cloak_of_molten_metal_stage_5_pt_03	This is a dread task but my rewards will be great, for I can spin gold from lead, and as the Supreme Patriarch is there is a more powerful ally you can have?! 	false
scripted_subtitles_localised_text_wh_main_qb_emp_balthasar_gelt_cloak_of_molten_metal_stage_5_pt_04	Begin your advance, banish the guardians of this place, and think of the rewards you will have once the Cloak of Molten Metal is mine! 	false
scripted_subtitles_localised_text_wh_main_qb_emp_balthasar_gelt_staff_of_volans_stage_3_pt_01	If Orr thinks he can take what is rightfully mine then he is very much mistaken! 	false
scripted_subtitles_localised_text_wh_main_qb_emp_balthasar_gelt_staff_of_volans_stage_3_pt_02	I will be Supreme Patriarch - I will wield the Staff of Volans! 	false
scripted_subtitles_localised_text_wh_main_qb_emp_balthasar_gelt_staff_of_volans_stage_3_pt_03	The Wind of Chamon will rise and blast any who get in my way! Now is the time for the Gold Order and I will brook no interference, any who get in my way will see their armour run into lead goblets, their blades melt and their bones turned to gold! 	false
scripted_subtitles_localised_text_wh_main_qb_emp_balthasar_gelt_staff_of_volans_stage_3_pt_04	Now, men, fight - bring me victory. The Emperor needs me, not some pathetic Pyromancer or insipid white wizard! 	false
scripted_subtitles_localised_text_wh_main_qb_emp_balthasar_gelt_staff_of_volans_stage_3_pt_05	For the good of the Empire, I will rise to the highest magical office in the land, and this fool will not stop me! 	false
scripted_subtitles_localised_text_wh_main_qb_emp_karl_franz_ghal_maraz_stage_4_pt_01	Now is the time, Men of the Empire, to unite - for the Orcs gather. Beyond the pass, a Warboss draws to him all that is foul - an Orc horde beyond imagining! 	false
scripted_subtitles_localised_text_wh_main_qb_emp_karl_franz_ghal_maraz_stage_4_pt_02	As Sigmar fought, so shall we;  we will become part of the legend; We will wipe the Orcs from our door; And only when this is done - when our nation has healed - shall I take up Ghal Maraz! 	false
scripted_subtitles_localised_text_wh_main_qb_emp_karl_franz_ghal_maraz_stage_4_pt_03	For Sigmar, for the Empire, for the WARHAMMER!	false
scripted_subtitles_localised_text_wh_main_qb_emp_karl_franz_intro_battle_of_bloodpine_woods_pt_01	Come, men - it seems Todbringer sends his Midden wolves across the Reik to test our mettle! 	false
scripted_subtitles_localised_text_wh_main_qb_emp_karl_franz_intro_battle_of_bloodpine_woods_pt_02	He seems to think that since my father’s death Reikland is weak and we cower under our beds waiting for these Ulric-worshippers to save us from our woes! 	false
scripted_subtitles_localised_text_wh_main_qb_emp_karl_franz_intro_battle_of_bloodpine_woods_pt_03	I say, we Reiklanders are more than capable of defending ourselves - I say, we show Todbringer’s mongrels that Reiklander blood flows through our veins! 	false
scripted_subtitles_localised_text_wh_main_qb_emp_karl_franz_intro_battle_of_bloodpine_woods_pt_04	We face the trespassers deep in the Bloodpines - keep your wits, lads, for there is more than Ulric’s dogs in there… My father had to send the Reiksguard in to purge these woods of Forest Goblin filth more than once during his reign. 	false
scripted_subtitles_localised_text_wh_main_qb_emp_karl_franz_intro_battle_of_bloodpine_woods_pt_05	Yet that is not what we face today. No, today we send the Elector Count of Middenland a message that it is the House of Franz that protects the borders of Reikland! 	false
scripted_subtitles_localised_text_wh_main_qb_emp_karl_franz_reikland_runefang_stage_3_pt_01	Hear me now, brave men - brave Reiklanders - hear me! 	false
scripted_subtitles_localised_text_wh_main_qb_emp_karl_franz_reikland_runefang_stage_3_pt_02	The Celestial Wizards read the portents true. Norse Raiders land on Nordland’s shores. We have marched many miles, but there is no distance so great that I would not gladly march it to face this - our ultimate foe!	false
scripted_subtitles_localised_text_wh_main_qb_emp_karl_franz_reikland_runefang_stage_3_pt_03	I have refused the honour of wielding the blade of our forebears thus far. I was not worthy. But should we survive this day, should we drive the ruinous tribes back across the sea - then, with your blessing - I will pick up the Reikland Runefang and use it to bleed our foes - to carve my way through Sigmar's enemies! 	false
scripted_subtitles_localised_text_wh_main_qb_emp_karl_franz_reikland_runefang_stage_3_pt_04	Are you with me, Men of the Empire? For when the Northmen come, they will attack hard as their despicable gods demand. We must be ready to push them back, thrust them into the sea in defence of the Empire! 	false
scripted_subtitles_localised_text_wh_main_qb_emp_karl_franz_reikland_runefang_stage_3_the_threat_from_the_north_01	Hear me now, brave men - brave Reiklanders - hear me! 	false
scripted_subtitles_localised_text_wh_main_qb_emp_karl_franz_reikland_runefang_stage_3_the_threat_from_the_north_02	The Celestial Wizards read the portents true. Norse Raiders land on Nordland’s shores. We have marched many miles, but there is no distance so great that I would not gladly march it to face this - our ultimate foe!	false
scripted_subtitles_localised_text_wh_main_qb_emp_karl_franz_reikland_runefang_stage_3_the_threat_from_the_north_03	I have refused the honour of wielding the blade of our forebears thus far. I was not worthy. But should we survive this day, should we drive the ruinous tribes back across the sea - then, with your blessing - I will pick up the Reikland Runefang and use it to bleed our foes - to carve my way through Sigmar's enemies! 	false
scripted_subtitles_localised_text_wh_main_qb_emp_karl_franz_reikland_runefang_stage_3_the_threat_from_the_north_04	Are you with me, Men of the Empire? For when the Northmen come, they will attack hard as their despicable Gods demand. We must be ready to push them back, thrust them into the sea in defence of the Empire! 	false
scripted_subtitles_localised_text_wh_main_qb_emp_karl_franz_silver_seal_stage_3.1_pt_01	We hunt this day! Yet our quarry is neither boar nor deer; no, we pursue the Undead! 	false
scripted_subtitles_localised_text_wh_main_qb_emp_karl_franz_silver_seal_stage_3.1_pt_02	The Witch Hunters bring word that a Vampire crone makes haste for Stirland with the Silver Seal in her clutches! I charge you brave men with not letting that Vampiress get to Sylvania!	false
scripted_subtitles_localised_text_wh_main_qb_emp_karl_franz_silver_seal_stage_3.1_pt_03	For we know she is a puppet, her strings pulled by that cursed wretch, von Carstein! Now, men, chase her down. Return to me what is mine and send these von Carstein beasts a message… by taking her head! 	false
scripted_subtitles_localised_text_wh_main_qb_emp_karl_franz_silver_seal_stage_3.1_pt_04	We have brought her to bay at the centre of a forsaken temple, syphoning off ill magicks to power her dread spells, have no doubt! Surround the crone - slay the creature before she can summon her minions. 	false
scripted_subtitles_localised_text_wh_main_qb_emp_karl_franz_silver_seal_stage_3.1_pt_05	By order of the Grand Theogonist - show no mercy! 	false
scripted_subtitles_localised_text_wh_main_qb_grn_azhag_the_slaughterer_azhags_ard_armour_stage_4_pt_01n	Dose Stoopid flouncy humies fink they can trounce all over our sacred ground. Dat burial mound iz Mork's property not some fishy-smellin lake-hag's...	false
scripted_subtitles_localised_text_wh_main_qb_grn_azhag_the_slaughterer_azhags_ard_armour_stage_4_pt_02n	Bloomin 'at, stop whisperin' at me, I know! 	false
scripted_subtitles_localised_text_wh_main_qb_grn_azhag_the_slaughterer_azhags_ard_armour_stage_4_pt_03n	Come on ladz, we're gonna stamp these gits and send them runnin' back to their pretty towers. I've 'ad my vision from Mork 'imself. He reckons if we doo this, it's gonna sort my armour out real good and I won't 'ave to knock you all about.	false
scripted_subtitles_localised_text_wh_main_qb_grn_azhag_the_slaughterer_azhags_ard_armour_stage_4_pt_04n	Wassat? Yez, we'll go south afterwards. 	false
scripted_subtitles_localised_text_wh_main_qb_grn_azhag_the_slaughterer_azhags_ard_armour_stage_4_pt_05n	Let'z go an' kill some Knights!	false
scripted_subtitles_localised_text_wh_main_qb_grn_azhag_the_slaughterer_crown_of_sorcery_stage_3_pt_01	Alright, ladz. ‘Ere's da plan!   	false
scripted_subtitles_localised_text_wh_main_qb_grn_azhag_the_slaughterer_crown_of_sorcery_stage_3_pt_02	We goin' into dis lost city. But before we can rummage, we got to clear out all dem Undead things. Give ‘em a good kickin'!	false
scripted_subtitles_localised_text_wh_main_qb_grn_azhag_the_slaughterer_crown_of_sorcery_stage_3_pt_03	Once we killed everyfing, no one’z ta go lootin’ until I say so. Dis is my plan so I get da top picks. I’m in charge now, an' I need a shiny Boss-‘at! Anyone ‘oo disobeyz will get a boot up dere backside!	false
scripted_subtitles_localised_text_wh_main_qb_grn_azhag_the_slaughterer_crown_of_sorcery_stage_3_pt_04	Remember, dis is a cursed place, da Shamans don't like it, so no messin' wiv stuff ya don't understand. If ya summon something from da void - yoo ‘ll ‘ave ta deal with it yerself!	false
scripted_subtitles_localised_text_wh_main_qb_grn_azhag_the_slaughterer_slaggas_slashas_stage_4_pt_01	Dese savages are gettin' in my way! They're led by som git called "Slagga". I want ‘iz ‘ead.	false
scripted_subtitles_localised_text_wh_main_qb_grn_azhag_the_slaughterer_slaggas_slashas_stage_4_pt_02	Shaddup, crown! Dis is not a waste of time! We kill ‘oo I say we kill!	false
scripted_subtitles_localised_text_wh_main_qb_grn_azhag_the_slaughterer_slaggas_slashas_stage_4_pt_03	The plan's simple... I want a full pincer movement - attacking from the east and west flanks at the same time, will increase our chances of success…	false
scripted_subtitles_localised_text_wh_main_qb_grn_azhag_the_slaughterer_slaggas_slashas_stage_4_pt_04	...Wot? Eh? Sodding dead bloke taking over my words again!	false
scripted_subtitles_localised_text_wh_main_qb_grn_azhag_the_slaughterer_slaggas_slashas_stage_4_pt_05	Get yer choppas out, ladz, it's time to move... And if ya want ta doo that flanking manoeuvre-wotsit, we probably should, cos I've got a feelin' it might work.	false
scripted_subtitles_localised_text_wh_main_qb_grn_grimgor_ironhide_blood_forged_armour_stage_4_pt_01	Those Chaos men, ‘ave got some shiny stuff. Fink they can keep it from us?! 	false
scripted_subtitles_localised_text_wh_main_qb_grn_grimgor_ironhide_blood_forged_armour_stage_4_pt_02	Dese Chaos-gitz are meant to be ‘ard… dey got squiffy Godz that will turn ‘em into gribbly monsterz if dey’re not! 	false
scripted_subtitles_localised_text_wh_main_qb_grn_grimgor_ironhide_blood_forged_armour_stage_4_pt_03	So we’re gonna ‘ave a good scrap, da northern humies better not disappoint! 	false
scripted_subtitles_localised_text_wh_main_qb_grn_grimgor_ironhide_blood_forged_armour_stage_4_pt_04	Wot’s more - they’re haulin’ a load of shiny stuff back from the big-hatted Stunties. They fink they can keep it from uz, I wantz it all! Go get ‘em, ladz! 	false
scripted_subtitles_localised_text_wh_main_qb_grn_grimgor_ironhide_gitsnik_stage_4_black_fire_pass_01	Raaaaargh! Dis iz it, Boyz! Time to give dis ‘Empera’ a right spankin’!	false
scripted_subtitles_localised_text_wh_main_qb_grn_grimgor_ironhide_gitsnik_stage_4_black_fire_pass_02	Me and da Immortulz will lead from da front and seek out da poncey crown-wearin’ git ridin' 'iz big pigeon!	false
scripted_subtitles_localised_text_wh_main_qb_grn_grimgor_ironhide_gitsnik_stage_4_black_fire_pass_03	My axe, Gitsnik, is somewhere in dat pass. A bag of teef to the Orc dat finds it and 'ands it over.	false
scripted_subtitles_localised_text_wh_main_qb_grn_grimgor_ironhide_gitsnik_stage_4_black_fire_pass_04	Any 'oo fink they're gonna keep it instead, well... you'll find my boot so far up yer arse, you'll be tasting squig-leather until yoo die - which will be straight after!	false
scripted_subtitles_localised_text_wh_main_qb_grn_grimgor_ironhide_gitsnik_stage_4_black_fire_pass_05	Anyway! Let’s give Gork a show - get smashin! I want dis pass filled with blood!	false
scripted_subtitles_localised_text_wh_main_qb_grn_grimgor_ironhide_gitsnik_stage_4_black_fire_pass_06	I want da Humies to remember my name for yearz and yearz… remember GRIMGOR!!!	false
scripted_subtitles_localised_text_wh_main_qb_grn_grimgor_ironhide_gitsnik_stage_4_pt_01	Raaaaargh! Dis iz it, Boyz! Time to give dis ‘Empera’ a right spankin’! Me and da Immortulz will lead from da front and seek out da poncey crown-wearin’ git ridin' on 'iz big pigeon!	false
scripted_subtitles_localised_text_wh_main_qb_grn_grimgor_ironhide_gitsnik_stage_4_pt_02	My axe, Gitsnik, is somewhere in dat pass. A bag of teef to the Orc dat finds it and 'ands it over.  	false
scripted_subtitles_localised_text_wh_main_qb_grn_grimgor_ironhide_gitsnik_stage_4_pt_03	Any 'oo fink they're gonna keep it instead, well... you'll find my boot so far up yer arse, you'll be tasting squig-leather until yoo die - which will be straight after! 	false
scripted_subtitles_localised_text_wh_main_qb_grn_grimgor_ironhide_gitsnik_stage_4_pt_04	Anyway! Let’s give Gork a show – get smashin! I want dis pass filled with blood, I want da Humies to remember my name for yearz and yearz… remember GRIMGOR!!!	false
scripted_subtitles_localised_text_wh_main_qb_grn_grimgor_ironhide_intro_subterranean_pt_01	Da Stunties come to stop us?! Hahahaha! 	false
scripted_subtitles_localised_text_wh_main_qb_grn_grimgor_ironhide_intro_subterranean_pt_02	Time for a ruck, I say! I'm gonna enjoy pulling dese beards from dere chins. 	false
scripted_subtitles_localised_text_wh_main_qb_grn_grimgor_ironhide_intro_subterranean_pt_03	First, though, we need to break dem big gunz - dats just cheatin’! I want som boyz on dat straight away. Stop their artillery from shootin’ and we get more time scrappin’, just as Mork like’s it! 	false
scripted_subtitles_localised_text_wh_main_qb_grn_grimgor_ironhide_intro_subterranean_pt_04	Watch it though, just cos dere short doesn’t mean one or two of ‘em aint ‘andy with their own choppas. Dey like fighting underground… but so do we! Ask any rat-man under Mount Red Eye! 	false
scripted_subtitles_localised_text_wh_main_qb_grn_grimgor_ironhide_intro_subterranean_pt_05	Right, Boyz, dats da plan. Immortulz, get yer choppas out, dis one's gonna be fun! 	false
scripted_subtitles_localised_text_wh_main_qb_vmp_heinrich_kemmler_chaos_tomb_blade_stage_4_pt_01	I see… I see… 	false
scripted_subtitles_localised_text_wh_main_qb_vmp_heinrich_kemmler_chaos_tomb_blade_stage_4_pt_02	These servants of the Ruinous Powers search for something… or someone. Oh, how delightful - could Krell be down there? If I could right what Grimbul Ironhelm did wrong and return Krell to Unlife, well, that would be a feat wouldn’t it? 	false
scripted_subtitles_localised_text_wh_main_qb_vmp_heinrich_kemmler_chaos_tomb_blade_stage_4_pt_03	And what other treasures are buried with the champion? What wondrous antiquities have been lost to the world? 	false
scripted_subtitles_localised_text_wh_main_qb_vmp_heinrich_kemmler_chaos_tomb_blade_stage_4_pt_04	A blade of great power, I’ll warrant! Should I let these blind fools have the spoils? I think not, I think they should make way for the Lichemaster, and if such an act angers their Dark Gods? Well, there are pacts to be made, secrets to share, and covenants to be sworn, I’m sure. 	false
scripted_subtitles_localised_text_wh_main_qb_vmp_heinrich_kemmler_chaos_tomb_blade_stage_4_pt_05	A decision has been made then, oh yes, slay the Chaos dogs - oust them for Kemmler, my pretties! 	false
scripted_subtitles_localised_text_wh_main_qb_vmp_heinrich_kemmler_cloak_of_mists_stage_3_pt_01	Oh dear me, oh no, we can’t have this, can we? 	false
scripted_subtitles_localised_text_wh_main_qb_vmp_heinrich_kemmler_cloak_of_mists_stage_3_pt_02	The treasures in that tomb - the spirit-essence that was once Marbad of the Endals - is mine to harvest, not for these impudent Goblins to worship. 	false
scripted_subtitles_localised_text_wh_main_qb_vmp_heinrich_kemmler_cloak_of_mists_stage_3_pt_03	What a to do - we shall have to sort this mess out! Punish these creatures, oh yes, make them think twice about trespassing on the barrows of the dead! 	false
scripted_subtitles_localised_text_wh_main_qb_vmp_heinrich_kemmler_cloak_of_mists_stage_3_pt_04	That’s right - slay the Goblins, my wondrous Wights, my warriors of bone, my monsters of necrotic flesh - do my bidding, release them of life! 	false
scripted_subtitles_localised_text_wh_main_qb_vmp_heinrich_kemmler_cloak_of_mists_stage_3_pt_05	Then the mist and shadows will form around me - a cloak formed of the stuff of night! 	false
scripted_subtitles_localised_text_wh_main_qb_vmp_heinrich_kemmler_skull_staff_stage_3_pt_01	How glorious! 	false
scripted_subtitles_localised_text_wh_main_qb_vmp_heinrich_kemmler_skull_staff_stage_3_pt_02	It has been such fun watching the Empire and Bretonnians rip each other apart. Supplying me with fresh stock as they do - oh, the irony!	false
scripted_subtitles_localised_text_wh_main_qb_vmp_heinrich_kemmler_skull_staff_stage_3_pt_03	But while pulling their strings, working them like puppets has been immensely satisfying - it is now time for direct intervention. 	false
scripted_subtitles_localised_text_wh_main_qb_vmp_heinrich_kemmler_skull_staff_stage_3_pt_04	This abbey, this altar of Taal is my desire, the Skull Staff within calls to me and I would have it. 	false
scripted_subtitles_localised_text_wh_main_qb_vmp_heinrich_kemmler_skull_staff_stage_3_pt_05	Let the chittering hordes come and claim their Warpstone if they must, for me, the true prize is that wand of Dark Magic. With it, the legend of the Lichemaster will only grow! 	false
scripted_subtitles_localised_text_wh_main_qb_vmp_heinrich_kemmler_skull_staff_stage_3_pt_06	My legions advance! Bring me bone, bring me flesh, but do not bring me these things back alive! 	false
scripted_subtitles_localised_text_wh_main_qb_vmp_mannfred_von_carstein_armour_of_templehof_stage_6_pt_01	I have always despised Bretonnia - a land ruled by some pitiful witch the smallfolk dare to call a god.	false
scripted_subtitles_localised_text_wh_main_qb_vmp_mannfred_von_carstein_armour_of_templehof_stage_6_pt_02	Only I can bring the night - the flower of Bretonnia shall wither and the tomb that holds mine prize be broken open and those inside shall serve me!	false
scripted_subtitles_localised_text_wh_main_qb_vmp_mannfred_von_carstein_armour_of_templehof_stage_6_pt_03	They shall know a true deity! I am a god, let thy grave-bound and thy living worship me - Mannfred the wise; Mannfred the Unliving, Mannfred the Merciless!	false
scripted_subtitles_localised_text_wh_main_qb_vmp_mannfred_von_carstein_intro_battle_of_hel_fenn_pt_01	Arise Grave-bound! I command thee to attend! 	false
scripted_subtitles_localised_text_wh_main_qb_vmp_mannfred_von_carstein_intro_battle_of_hel_fenn_pt_02	Franz - the son of whores and tumorous Burgomeisters - thinks the crown is his! But the house of the Reikland Electors is tainted. As the last great count of Stirland, mine claim is the truest, I should be Emperor - I *will* be Emperor!  	false
scripted_subtitles_localised_text_wh_main_qb_vmp_mannfred_von_carstein_intro_battle_of_hel_fenn_pt_03	Bring thy swords…Go, mine minions, reap death - dance a Danse Macabre!	false
scripted_subtitles_localised_text_wh_main_qb_vmp_mannfred_von_carstein_sword_of_unholy_power_stage_4_pt_01	Look how the insects gather around the Arcane Fulcrum, chanting their pathetic rituals.	false
scripted_subtitles_localised_text_wh_main_qb_vmp_mannfred_von_carstein_sword_of_unholy_power_stage_4_pt_02	We shall slaughter them in its shadow, ensorcelling the Pillar of Bone with Necromantic energy, and then mine blade will be bathed in unholy power! 	false
scripted_subtitles_localised_text_wh_main_qb_vmp_mannfred_von_carstein_sword_of_unholy_power_stage_4_pt_03	It is time! The Dead March!	false
scripted_subtitles_localised_text_wh_pro01_qb_dwf_grombrindal_glimril_scales_pt_01	Wazzock! You slime-worshippin' umgi filth-merchant! Get your arse and that pet reptile over here!	false
scripted_subtitles_localised_text_wh_pro01_qb_dwf_grombrindal_glimril_scales_pt_02	I would have words with your little beast face-to-face, so that I may lop off its claw and reclaim what is mine.	false
scripted_subtitles_localised_text_wh_pro01_qb_dwf_grombrindal_glimril_scales_pt_03	Those scales are from my armour and no thief steals from the White Dwarf and lives.	false
scripted_subtitles_localised_text_wh_pro01_qb_dwf_grombrindal_glimril_scales_pt_04	You and your followers will die - that is my oath, as my kin, Grimnir, is witness! 	false
scripted_subtitles_localised_text_wh_pro01_qb_dwf_grombrindal_rune_axe_pt_01	Right, my northern kin, let's get about this. 	false
scripted_subtitles_localised_text_wh_pro01_qb_dwf_grombrindal_rune_axe_pt_02	These Chaos-lovin' umgi are in need of a reckoning, alright.	false
scripted_subtitles_localised_text_wh_pro01_qb_dwf_grombrindal_rune_axe_pt_03	I have an oath to fulfil, so don't mind me if I'm greedy, but I need to kill lots of kruti braggarts to get my axe channelin' me runes. 	false
scripted_subtitles_localised_text_wh_pro01_qb_dwf_grombrindal_rune_axe_pt_04	I promised Grimnir they'd be a mighty tally and I ain't one for breaking such an oath. So come on! Let's have 'em!!!	false
scripted_subtitles_localised_text_wh_pro01_qb_dwf_grombrindal_rune_cloak_of_valaya_pt_01	Our Goddess has spoken to me! She who prepares the hearth; who secures our Holds. 	false
scripted_subtitles_localised_text_wh_pro01_qb_dwf_grombrindal_rune_cloak_of_valaya_pt_02	Uzkular have been caught sneaking about like rat-men filth, trying to gain access to our mountains unseen.	false
scripted_subtitles_localised_text_wh_pro01_qb_dwf_grombrindal_rune_cloak_of_valaya_pt_03	Well, I see you, scum, and by Valaya's cloak I'll have every last rotten one of you back in that ground, pushing up your tombstones!	false
scripted_subtitles_localised_text_wh_pro01_qb_dwf_grombrindal_rune_helm_of_zhufbar_pt_01	At last, we have lured the Orcs to the place we Dawi fight best - in Grungni's realm!	false
scripted_subtitles_localised_text_wh_pro01_qb_dwf_grombrindal_rune_helm_of_zhufbar_pt_02	I see beside me brave Dwarfen hearts. Such courage will imbue my Rune Helm. This is a day to strike many grudges from the great book,	false
scripted_subtitles_localised_text_wh_pro01_qb_dwf_grombrindal_rune_helm_of_zhufbar_pt_03	for I am the White Dwarf and only worthy folk appear in my pages... 	false
scripted_subtitles_localised_text_wh_pro01_qb_dwf_grombrindal_rune_helm_of_zhufbar_pt_04	So, let us record great deeds this day, and give these urki scum a right royal hammerin'!	false
scripted_subtitles_localised_text_wh_pro02_qb_vmp_isabella_blood_chalice_of_bathori_ancient_tomb_pt_01	Oh, these poor, fragile mortals… how they arrange themselves before me; proud and defiant. 	false
scripted_subtitles_localised_text_wh_pro02_qb_vmp_isabella_blood_chalice_of_bathori_ancient_tomb_pt_02	Soon I shall make them prostrate and subservient. In death, they will become servants to the von Carsteins, pliable and deliciously loyal.	false
scripted_subtitles_localised_text_wh_pro02_qb_vmp_isabella_blood_chalice_of_bathori_ancient_tomb_pt_03	Beyond this rabble is the tomb of a soul so great and so powerful that when it flows into this ancient chalice, the power bestowed upon me will make the world tremble! 	false
scripted_subtitles_localised_text_wh_pro02_qb_vmp_isabella_blood_chalice_of_bathori_ancient_tomb_pt_04	Bring me what I am owed!	false
