key	text	tooltip
#Loc;1;text/db/unit_set_to_mp_unit_caps__.loc		
unit_set_to_mp_unit_caps_localised_name_mp_cap_group_360_degree_fire	Units with 360 Degree Firing Arc	false
unit_set_to_mp_unit_caps_localised_name_mp_cap_group_chariots_warmachines	Chariots & War Machines	false
unit_set_to_mp_unit_caps_localised_name_mp_cap_group_chd_veh_train	Trains	false
unit_set_to_mp_unit_caps_localised_name_mp_cap_group_extended_roster	Extended Roster	false
unit_set_to_mp_unit_caps_localised_name_mp_cap_group_extended_roster_chaos_daemon_unitswh_main_sc_chs_chaos	Extended Roster	false
unit_set_to_mp_unit_caps_localised_name_mp_cap_group_extended_roster_dwarfswh_main_sc_dwf_dwarfs	{{tr:unit_set_to_mp_unit_caps_localised_name_mp_cap_group_extended_roster}}	false
unit_set_to_mp_unit_caps_localised_name_mp_cap_group_extended_roster_rakarth_unitswh2_main_sc_def_dark_elves	Extended Roster	false
unit_set_to_mp_unit_caps_localised_name_mp_cap_group_extended_roster_vampire_countswh_main_sc_vmp_vampire_counts	Extended Roster	false
unit_set_to_mp_unit_caps_localised_name_mp_cap_group_flying_unit	Flying Units	false
unit_set_to_mp_unit_caps_localised_name_mp_cap_group_heroes	Heroes	false
unit_set_to_mp_unit_caps_localised_name_mp_cap_group_joke_speed	Extremely Fast Entities	false
unit_set_to_mp_unit_caps_localised_name_mp_cap_group_mark_of_chaoswh_dlc03_sc_bst_beastmen	Units with a Mark of Chaos	false
unit_set_to_mp_unit_caps_localised_name_mp_cap_group_mark_of_chaoswh_main_sc_chs_chaos	Units with a Mark of Chaos	false
unit_set_to_mp_unit_caps_localised_name_mp_cap_group_missile_cav_chariots_warmachines	Missile Cavalry, Chariots & War Machines	false
unit_set_to_mp_unit_caps_localised_name_mp_cap_group_ranged_units	Missile Units	false
unit_set_to_mp_unit_caps_localised_name_mp_cap_group_rare_single_entities	Rare Single Entities	false
unit_set_to_mp_unit_caps_localised_name_mp_cap_group_single_entities	Single Entity Characters, Monsters & War Machines	false
unit_set_to_mp_unit_caps_localised_name_mp_cap_hero_aekold_helbrass	Aekold Helbrass	false
unit_set_to_mp_unit_caps_localised_name_mp_cap_hero_ariel	Ariel	false
unit_set_to_mp_unit_caps_localised_name_mp_cap_hero_blue_scribes	The Blue Scribes	false
unit_set_to_mp_unit_caps_localised_name_mp_cap_hero_bragg	Bragg the Gutsman	false
unit_set_to_mp_unit_caps_localised_name_mp_cap_hero_felix	Felix	false
unit_set_to_mp_unit_caps_localised_name_mp_cap_hero_garagrim_ironfist	{{tr:land_units_onscreen_name_wh3_dlc25_dwf_cha_garagrim_ironfist}}	false
unit_set_to_mp_unit_caps_localised_name_mp_cap_hero_ghoritch	Ghoritch	false
unit_set_to_mp_unit_caps_localised_name_mp_cap_hero_golden_knight	{{tr:land_units_onscreen_name_wh3_dlc24_ksl_cha_golden_knight}}	false
unit_set_to_mp_unit_caps_localised_name_mp_cap_hero_gorduz_backstabber	Gorduz Backstabber	false
unit_set_to_mp_unit_caps_localised_name_mp_cap_hero_gotrek	Gotrek	false
unit_set_to_mp_unit_caps_localised_name_mp_cap_hero_green_knight	Green Knight	false
unit_set_to_mp_unit_caps_localised_name_mp_cap_hero_harald_hammerstorm	Harald Hammerstorm	false
unit_set_to_mp_unit_caps_localised_name_mp_cap_hero_henri_le_massif	Henri	false
unit_set_to_mp_unit_caps_localised_name_mp_cap_hero_hertwig	Hertwig	false
unit_set_to_mp_unit_caps_localised_name_mp_cap_hero_jorek	Jorek	false
unit_set_to_mp_unit_caps_localised_name_mp_cap_hero_kalara	Kalara	false
unit_set_to_mp_unit_caps_localised_name_mp_cap_hero_karanak	{{tr:land_units_onscreen_name_wh3_pro12_kho_cha_karanak}}	false
unit_set_to_mp_unit_caps_localised_name_mp_cap_hero_kayzk	Kayzk the Befouled	false
unit_set_to_mp_unit_caps_localised_name_mp_cap_hero_lord_kroak	Lord Kroak	false
unit_set_to_mp_unit_caps_localised_name_mp_cap_hero_rodrik	Rodrik	false
unit_set_to_mp_unit_caps_localised_name_mp_cap_hero_saytang	Saytang the Watcher	false
unit_set_to_mp_unit_caps_localised_name_mp_cap_hero_scyla	Scyla Anfingrimm	false
unit_set_to_mp_unit_caps_localised_name_mp_cap_hero_skarr	Skarr Bloodwrath	false
unit_set_to_mp_unit_caps_localised_name_mp_cap_hero_snagla_grobspit	Snagla Grobspit	false
unit_set_to_mp_unit_caps_localised_name_mp_cap_hero_theodore_bruckner	{{tr:land_units_onscreen_name_wh3_dlc25_emp_cha_theodore_bruckner}}	false
unit_set_to_mp_unit_caps_localised_name_mp_cap_hero_ulrika	Ulrika Magdova	false
unit_set_to_mp_unit_caps_localised_name_mp_cap_unit_brt_art_blessed_field_trebuchet	Blessed Field Trebuchet	false
unit_set_to_mp_unit_caps_localised_name_mp_cap_unit_brt_art_field_trebuchet	Field Trebuchet	false
unit_set_to_mp_unit_caps_localised_name_mp_cap_unit_brt_cav_grail_guardians	Grail Guardians	false
unit_set_to_mp_unit_caps_localised_name_mp_cap_unit_brt_cav_grail_knights	Grail Knights	false
unit_set_to_mp_unit_caps_localised_name_mp_cap_unit_brt_cav_hippogryph_knights	Royal Hippogryph Knights	false
unit_set_to_mp_unit_caps_localised_name_mp_cap_unit_brt_cav_knights_errant	Knights Errant	false
unit_set_to_mp_unit_caps_localised_name_mp_cap_unit_brt_cav_knights_errant_ror_0	Defenders of the Fleur-de-Lis	false
unit_set_to_mp_unit_caps_localised_name_mp_cap_unit_brt_cav_knights_of_the_realm	Knights of the Realm	false
unit_set_to_mp_unit_caps_localised_name_mp_cap_unit_brt_cav_knights_of_the_realm_ror_0	Knights of the Lionhearted	false
unit_set_to_mp_unit_caps_localised_name_mp_cap_unit_brt_cav_mounted_yeomen_0	Mounted Yeomen	false
unit_set_to_mp_unit_caps_localised_name_mp_cap_unit_brt_cav_mounted_yeomen_1	Mounted Yeomen Archers	false
unit_set_to_mp_unit_caps_localised_name_mp_cap_unit_brt_cav_mounted_yeomen_ror_0	Wardens of Montfort	false
unit_set_to_mp_unit_caps_localised_name_mp_cap_unit_brt_cav_pegasus_knights	Pegasus Knights	false
unit_set_to_mp_unit_caps_localised_name_mp_cap_unit_brt_cav_questing_knights	Questing Knights	false
unit_set_to_mp_unit_caps_localised_name_mp_cap_unit_brt_cav_questing_knights_ror_0	The Companions of Quenelles	false
unit_set_to_mp_unit_caps_localised_name_mp_cap_unit_brt_cav_royal_pegasus_knights	Royal Pegasus Knights	false
unit_set_to_mp_unit_caps_localised_name_mp_cap_unit_brt_inf_battle_pilgrims	Battle Pilgrims	false
unit_set_to_mp_unit_caps_localised_name_mp_cap_unit_brt_inf_battle_pilgrims_ror_0	The Holy Wardens of La Maisontaal	false
unit_set_to_mp_unit_caps_localised_name_mp_cap_unit_brt_inf_foot_squires	Foot Squires	false
unit_set_to_mp_unit_caps_localised_name_mp_cap_unit_brt_inf_foot_squires_ror_0	Beastslayers of Bastonne	false
unit_set_to_mp_unit_caps_localised_name_mp_cap_unit_brt_inf_grail_relique	Grail Relique	false
unit_set_to_mp_unit_caps_localised_name_mp_cap_unit_brt_inf_men_at_arms	Men-at-Arms	false
unit_set_to_mp_unit_caps_localised_name_mp_cap_unit_brt_inf_men_at_arms_polearms	Men-at-Arms (Polearms)	false
unit_set_to_mp_unit_caps_localised_name_mp_cap_unit_brt_inf_men_at_arms_shields	Men-at-Arms (Shields)	false
unit_set_to_mp_unit_caps_localised_name_mp_cap_unit_brt_inf_peasant_bowmen	Peasant Bowmen	false
unit_set_to_mp_unit_caps_localised_name_mp_cap_unit_brt_inf_peasant_bowmen_fire	Peasant Bowmen (Fire Arrows)	false
unit_set_to_mp_unit_caps_localised_name_mp_cap_unit_brt_inf_peasant_bowmen_pox	Peasant Bowmen (Pox Arrows)	false
unit_set_to_mp_unit_caps_localised_name_mp_cap_unit_brt_inf_peasant_mob	Peasant Mob	false
unit_set_to_mp_unit_caps_localised_name_mp_cap_unit_brt_inf_spearmen_at_arms	Spearmen-at-Arms	false
unit_set_to_mp_unit_caps_localised_name_mp_cap_unit_brt_inf_spearmen_at_arms_shields	Spearmen-at-Arms (Shields)	false
unit_set_to_mp_unit_caps_localised_name_mp_cap_unit_bst_cav_centigors	Centigors	false
unit_set_to_mp_unit_caps_localised_name_mp_cap_unit_bst_cav_centigors_great_weapons	Centigors (Great Weapons)	false
unit_set_to_mp_unit_caps_localised_name_mp_cap_unit_bst_cav_centigors_throwing_axes	Centigors (Throwing Axes)	false
unit_set_to_mp_unit_caps_localised_name_mp_cap_unit_bst_cav_tuskgor_chariot	Tuskgor Chariots	false
unit_set_to_mp_unit_caps_localised_name_mp_cap_unit_bst_centigors_throwing_axes_ror	Groghooves of Wolf's Run	false
unit_set_to_mp_unit_caps_localised_name_mp_cap_unit_bst_inf_bestigor_herd_ror_0	Khorrok's Manrippers	false
unit_set_to_mp_unit_caps_localised_name_mp_cap_unit_bst_inf_bestigors	Bestigors	false
unit_set_to_mp_unit_caps_localised_name_mp_cap_unit_bst_inf_centigors_ror_0	Sons of Ghorros	false
unit_set_to_mp_unit_caps_localised_name_mp_cap_unit_bst_inf_chaos_warhounds_0	Chaos Warhounds	false
unit_set_to_mp_unit_caps_localised_name_mp_cap_unit_bst_inf_chaos_warhounds_1	Chaos Warhounds	false
unit_set_to_mp_unit_caps_localised_name_mp_cap_unit_bst_inf_cygor_ror_0	The Eye of Morrslieb	false
unit_set_to_mp_unit_caps_localised_name_mp_cap_unit_bst_inf_gor_herd_0	Gor Herd	false
unit_set_to_mp_unit_caps_localised_name_mp_cap_unit_bst_inf_gor_herd_1	Gor Herd (Shields)	false
unit_set_to_mp_unit_caps_localised_name_mp_cap_unit_bst_inf_gor_herd_great_weapons	Gor Herd (Great Weapons)	false
unit_set_to_mp_unit_caps_localised_name_mp_cap_unit_bst_inf_gor_herd_ror_0	Black-Horn's Ravagers	false
unit_set_to_mp_unit_caps_localised_name_mp_cap_unit_bst_inf_harpies	Harpies	false
unit_set_to_mp_unit_caps_localised_name_mp_cap_unit_bst_inf_khorngors	Khorngors	false
unit_set_to_mp_unit_caps_localised_name_mp_cap_unit_bst_inf_minotaurs_ror_0	Butchers of Kalkengard	false
unit_set_to_mp_unit_caps_localised_name_mp_cap_unit_bst_inf_tzaangors	Tzaangors	false
unit_set_to_mp_unit_caps_localised_name_mp_cap_unit_bst_inf_ungor_herd	Ungor Herd	false
unit_set_to_mp_unit_caps_localised_name_mp_cap_unit_bst_inf_ungor_raiders	Ungor Raiders	false
unit_set_to_mp_unit_caps_localised_name_mp_cap_unit_bst_inf_ungor_spearmen_0	Ungor Spearmen	false
unit_set_to_mp_unit_caps_localised_name_mp_cap_unit_bst_inf_ungor_spearmen_1	Ungor Spearmen (Shields)	false
unit_set_to_mp_unit_caps_localised_name_mp_cap_unit_bst_inf_ungor_spearmen_ror_0	Destroyers of the Drakwald	false
unit_set_to_mp_unit_caps_localised_name_mp_cap_unit_bst_mon_chaos_spawn	Chaos Spawn	false
unit_set_to_mp_unit_caps_localised_name_mp_cap_unit_bst_mon_cockatrice	Cockatrice	false
unit_set_to_mp_unit_caps_localised_name_mp_cap_unit_bst_mon_cygor	Cygor	false
unit_set_to_mp_unit_caps_localised_name_mp_cap_unit_bst_mon_ghorgon	Ghorgon	false
unit_set_to_mp_unit_caps_localised_name_mp_cap_unit_bst_mon_ghorgon_ror	The Bloodbrute Behemoth	false
unit_set_to_mp_unit_caps_localised_name_mp_cap_unit_bst_mon_giant	Giant	false
unit_set_to_mp_unit_caps_localised_name_mp_cap_unit_bst_mon_jabberslythe	Jabberslythe	false
unit_set_to_mp_unit_caps_localised_name_mp_cap_unit_bst_mon_jabberslythe_ror	The Vorbergland Broodmother	false
unit_set_to_mp_unit_caps_localised_name_mp_cap_unit_bst_mon_minotaurs_0	Minotaurs	false
unit_set_to_mp_unit_caps_localised_name_mp_cap_unit_bst_mon_minotaurs_1	Minotaurs (Shields)	false
unit_set_to_mp_unit_caps_localised_name_mp_cap_unit_bst_mon_minotaurs_2	Minotaurs (Great Weapons)	false
unit_set_to_mp_unit_caps_localised_name_mp_cap_unit_bst_mon_razorgor_herd	Razorgor Herd	false
unit_set_to_mp_unit_caps_localised_name_mp_cap_unit_bst_veh_razorgor_chariot	Razorgor Chariots	false
unit_set_to_mp_unit_caps_localised_name_mp_cap_unit_chd_cav_bull_centaurs_axe	Bull Centaur Renders	false
unit_set_to_mp_unit_caps_localised_name_mp_cap_unit_chd_cav_bull_centaurs_dual_axe	Bull Centaur Renders (Dual Axes)	false
unit_set_to_mp_unit_caps_localised_name_mp_cap_unit_chd_cav_bull_centaurs_dual_axe_ror	Hashut's Dark Ravagers	false
unit_set_to_mp_unit_caps_localised_name_mp_cap_unit_chd_cav_bull_centaurs_greatweapons	Bull Centaur Renders (Great Weapons)	false
unit_set_to_mp_unit_caps_localised_name_mp_cap_unit_chd_cav_hobgoblin_wolf_raiders_bows	Hobgoblin Wolf Raiders (Bows)	false
unit_set_to_mp_unit_caps_localised_name_mp_cap_unit_chd_cav_hobgoblin_wolf_raiders_ror	Oglah Khan's Wolf Boyz	false
unit_set_to_mp_unit_caps_localised_name_mp_cap_unit_chd_cav_hobgoblin_wolf_raiders_spears	Hobgoblin Wolf Raiders (Spears)	false
unit_set_to_mp_unit_caps_localised_name_mp_cap_unit_chd_cav_hobgoblin_wolf_raiders_swords	Hobgoblin Wolf Raiders	false
unit_set_to_mp_unit_caps_localised_name_mp_cap_unit_chd_inf_chaos_dwarf_blunderbusses	Chaos Dwarf Blunderbusses	false
unit_set_to_mp_unit_caps_localised_name_mp_cap_unit_chd_inf_chaos_dwarf_blunderbusses_ror	The Granite Guard	false
unit_set_to_mp_unit_caps_localised_name_mp_cap_unit_chd_inf_chaos_dwarf_warrior_ror	The Blazing Beards of Bazherak	false
unit_set_to_mp_unit_caps_localised_name_mp_cap_unit_chd_inf_chaos_dwarf_warriors	Chaos Dwarf Warriors	false
unit_set_to_mp_unit_caps_localised_name_mp_cap_unit_chd_inf_chaos_dwarf_warriors_great_weapons	Chaos Dwarf Warriors (Great Weapons)	false
unit_set_to_mp_unit_caps_localised_name_mp_cap_unit_chd_inf_goblin_labourers	Goblin Labourers	false
unit_set_to_mp_unit_caps_localised_name_mp_cap_unit_chd_inf_hobgoblin_archers	Hobgoblin Archers	false
unit_set_to_mp_unit_caps_localised_name_mp_cap_unit_chd_inf_hobgoblin_cutthroats	Hobgoblin Cutthroats	false
unit_set_to_mp_unit_caps_localised_name_mp_cap_unit_chd_inf_hobgoblin_sneaky_gits	Hobgoblin Sneaky Gits	false
unit_set_to_mp_unit_caps_localised_name_mp_cap_unit_chd_inf_infernal_guard	Infernal Guard	false
unit_set_to_mp_unit_caps_localised_name_mp_cap_unit_chd_inf_infernal_guard_fireglaives	Infernal Guard (Fireglaives)	false
unit_set_to_mp_unit_caps_localised_name_mp_cap_unit_chd_inf_infernal_guard_great_weapons	Infernal Guard (Great Weapons)	false
unit_set_to_mp_unit_caps_localised_name_mp_cap_unit_chd_inf_infernal_ironsworn	Infernal Ironsworn	false
unit_set_to_mp_unit_caps_localised_name_mp_cap_unit_chd_inf_infernal_ironsworn_ror	The Immortals	false
unit_set_to_mp_unit_caps_localised_name_mp_cap_unit_chd_inf_orc_labourers	Orc Labourers	false
unit_set_to_mp_unit_caps_localised_name_mp_cap_unit_chd_mon_bale_taurus	Bale Taurus	false
unit_set_to_mp_unit_caps_localised_name_mp_cap_unit_chd_mon_great_taurus	Great Taurus	false
unit_set_to_mp_unit_caps_localised_name_mp_cap_unit_chd_mon_kdaai_destroyer	K'daai Destroyer	false
unit_set_to_mp_unit_caps_localised_name_mp_cap_unit_chd_mon_kdaai_fireborn	K'daai Fireborn	false
unit_set_to_mp_unit_caps_localised_name_mp_cap_unit_chd_mon_lammasu	Lammasu	false
unit_set_to_mp_unit_caps_localised_name_mp_cap_unit_chd_veh_bolt_thrower	{{tr:land_units_onscreen_name_wh3_main_chd_art_hobgob_bolt_thrower}}	false
unit_set_to_mp_unit_caps_localised_name_mp_cap_unit_chd_veh_deathshrieker_rocket_launcher	Deathshrieker Rocket Launcher	false
unit_set_to_mp_unit_caps_localised_name_mp_cap_unit_chd_veh_dreadquake_mortar	Dreadquake Mortar	false
unit_set_to_mp_unit_caps_localised_name_mp_cap_unit_chd_veh_iron_daemon	Iron Daemon	false
unit_set_to_mp_unit_caps_localised_name_mp_cap_unit_chd_veh_iron_daemon_ror	The Daemon's Tongue	false
unit_set_to_mp_unit_caps_localised_name_mp_cap_unit_chd_veh_magma_cannon	Magma Cannon	false
unit_set_to_mp_unit_caps_localised_name_mp_cap_unit_chd_veh_skullcracker	Skullcracker	false
unit_set_to_mp_unit_caps_localised_name_mp_cap_unit_chs_art_hellcannon	Hellcannon	false
unit_set_to_mp_unit_caps_localised_name_mp_cap_unit_chs_art_hellcannon_ror_0	The Soul of Damnation	false
unit_set_to_mp_unit_caps_localised_name_mp_cap_unit_chs_cav_chaos_chariot_msla_ror	The Sibilant Slaughtercade	false
unit_set_to_mp_unit_caps_localised_name_mp_cap_unit_chs_cav_chaos_chariots	Chaos Chariots	false
unit_set_to_mp_unit_caps_localised_name_mp_cap_unit_chs_cav_chaos_knights	Chaos Knights	false
unit_set_to_mp_unit_caps_localised_name_mp_cap_unit_chs_cav_chaos_knights_lances	Chaos Knights (Lances)	false
unit_set_to_mp_unit_caps_localised_name_mp_cap_unit_chs_cav_chaos_knights_ror	Swords of Chaos	false
unit_set_to_mp_unit_caps_localised_name_mp_cap_unit_chs_cav_marauder_horsemasters	Marauder Horsemasters	false
unit_set_to_mp_unit_caps_localised_name_mp_cap_unit_chs_cav_marauder_horsemen_javelins	Marauder Horsemen	false
unit_set_to_mp_unit_caps_localised_name_mp_cap_unit_chs_cav_marauder_horsemen_mkho	Marauder Horsemen of Khorne	false
unit_set_to_mp_unit_caps_localised_name_mp_cap_unit_chs_cav_marauder_horsemen_mnur	Marauder Horsemen of Nurgle	false
unit_set_to_mp_unit_caps_localised_name_mp_cap_unit_chs_cav_marauder_horsemen_msla	Marauder Horsemen of Slaanesh	false
unit_set_to_mp_unit_caps_localised_name_mp_cap_unit_chs_cav_marauder_horsemen_mtze	Marauder Horsemen of Tzeentch	false
unit_set_to_mp_unit_caps_localised_name_mp_cap_unit_chs_cav_marauder_horsemen_throwing_axes	Marauder Horsemen (Throwing Axes)	false
unit_set_to_mp_unit_caps_localised_name_mp_cap_unit_chs_cav_skullcrushers_mkho_ror	Knights of the Brazen Throne	false
unit_set_to_mp_unit_caps_localised_name_mp_cap_unit_chs_inf_aspiring_champions	Aspiring Champions	false
unit_set_to_mp_unit_caps_localised_name_mp_cap_unit_chs_inf_aspiring_champions_mtze_ror	The Severed Claw	false
unit_set_to_mp_unit_caps_localised_name_mp_cap_unit_chs_inf_chaos_marauders	Chaos Marauders	false
unit_set_to_mp_unit_caps_localised_name_mp_cap_unit_chs_inf_chaos_marauders_dualweapons	Chaos Marauders (Dual Weapons)	false
unit_set_to_mp_unit_caps_localised_name_mp_cap_unit_chs_inf_chaos_marauders_greatweapons	Chaos Marauders (Great Weapons)	false
unit_set_to_mp_unit_caps_localised_name_mp_cap_unit_chs_inf_chaos_marauders_hellscourges	Chaos Marauders (Hellscourges)	false
unit_set_to_mp_unit_caps_localised_name_mp_cap_unit_chs_inf_chaos_marauders_spears	Chaos Marauders (Spears)	false
unit_set_to_mp_unit_caps_localised_name_mp_cap_unit_chs_inf_chaos_warhounds_0	Chaos Warhounds	false
unit_set_to_mp_unit_caps_localised_name_mp_cap_unit_chs_inf_chaos_warhounds_1	Chaos Warhounds (Poison)	false
unit_set_to_mp_unit_caps_localised_name_mp_cap_unit_chs_inf_chaos_warriors	Chaos Warriors	false
unit_set_to_mp_unit_caps_localised_name_mp_cap_unit_chs_inf_chaos_warriors_dualweapons	Chaos Warriors (Dual Weapons)	false
unit_set_to_mp_unit_caps_localised_name_mp_cap_unit_chs_inf_chaos_warriors_greatweapons	Chaos Warriors (Great Weapons)	false
unit_set_to_mp_unit_caps_localised_name_mp_cap_unit_chs_inf_chaos_warriors_halberds	Chaos Warriors (Halberds)	false
unit_set_to_mp_unit_caps_localised_name_mp_cap_unit_chs_inf_chaos_warriors_hellscourges	Chaos Warriors (Hellscourges)	false
unit_set_to_mp_unit_caps_localised_name_mp_cap_unit_chs_inf_chaos_warriors_ror	Mirror Guard	false
unit_set_to_mp_unit_caps_localised_name_mp_cap_unit_chs_inf_chosen	Chosen	false
unit_set_to_mp_unit_caps_localised_name_mp_cap_unit_chs_inf_chosen_dualweapons	Chosen (Dual Weapons)	false
unit_set_to_mp_unit_caps_localised_name_mp_cap_unit_chs_inf_chosen_greatweapons	Chosen (Great Weapons)	false
unit_set_to_mp_unit_caps_localised_name_mp_cap_unit_chs_inf_chosen_halberds	Chosen (Halberds)	false
unit_set_to_mp_unit_caps_localised_name_mp_cap_unit_chs_inf_chosen_hellscourges	Chosen (Hellscourges)	false
unit_set_to_mp_unit_caps_localised_name_mp_cap_unit_chs_inf_chosen_mkho_ror	{{tr:land_units_onscreen_name_wh3_dlc26_chs_inf_chosen_mkho_ror}}	false
unit_set_to_mp_unit_caps_localised_name_mp_cap_unit_chs_inf_forsaken	Forsaken	false
unit_set_to_mp_unit_caps_localised_name_mp_cap_unit_chs_inf_forsaken_ror_0	The Daemonspew	false
unit_set_to_mp_unit_caps_localised_name_mp_cap_unit_chs_mon_chaos_spawn	Chaos Spawn	false
unit_set_to_mp_unit_caps_localised_name_mp_cap_unit_chs_mon_chaos_spawn_ror_0	Wyrd Spawn	false
unit_set_to_mp_unit_caps_localised_name_mp_cap_unit_chs_mon_chaos_trolls_0	Chaos Trolls	false
unit_set_to_mp_unit_caps_localised_name_mp_cap_unit_chs_mon_chaos_trolls_1	Chaos Trolls (Armoured)	false
unit_set_to_mp_unit_caps_localised_name_mp_cap_unit_chs_mon_dragon_ogre_ror_0	Summoners of Rage	false
unit_set_to_mp_unit_caps_localised_name_mp_cap_unit_chs_mon_dragon_ogre_shaggoth	Dragon Ogre Shaggoths	false
unit_set_to_mp_unit_caps_localised_name_mp_cap_unit_chs_mon_dragon_ogres	Dragon Ogres	false
unit_set_to_mp_unit_caps_localised_name_mp_cap_unit_chs_mon_feral_manticore	Feral Manticore	false
unit_set_to_mp_unit_caps_localised_name_mp_cap_unit_chs_mon_giant	Chaos Giant	false
unit_set_to_mp_unit_caps_localised_name_mp_cap_unit_chs_mon_giant_mnur_ror	Bilious Thunderguff	false
unit_set_to_mp_unit_caps_localised_name_mp_cap_unit_chs_mon_warshrine	Chaos Warshrine	false
unit_set_to_mp_unit_caps_localised_name_mp_cap_unit_chs_veh_gorebeast_chariot	Gorebeast Chariots	false
unit_set_to_mp_unit_caps_localised_name_mp_cap_unit_cst_art_carronade	Carronade	false
unit_set_to_mp_unit_caps_localised_name_mp_cap_unit_cst_art_mortar	Mortar	false
unit_set_to_mp_unit_caps_localised_name_mp_cap_unit_cst_art_queen_bess	Queen Bess	false
unit_set_to_mp_unit_caps_localised_name_mp_cap_unit_cst_cav_deck_droppers_0	Deck Droppers	false
unit_set_to_mp_unit_caps_localised_name_mp_cap_unit_cst_cav_deck_droppers_1	Deck Droppers (Bombers)	false
unit_set_to_mp_unit_caps_localised_name_mp_cap_unit_cst_cav_deck_droppers_2	Deck Droppers (Handguns)	false
unit_set_to_mp_unit_caps_localised_name_mp_cap_unit_cst_cav_deck_droppers_ror_0	Salt Lord Scuttlers	false
unit_set_to_mp_unit_caps_localised_name_mp_cap_unit_cst_inf_deck_gunners_0	Deck Gunners	false
unit_set_to_mp_unit_caps_localised_name_mp_cap_unit_cst_inf_deck_gunners_ror_0	Shadewraith Gunners	false
unit_set_to_mp_unit_caps_localised_name_mp_cap_unit_cst_inf_deckhands_mob_0	Zombie Pirate Deckhands Mob	false
unit_set_to_mp_unit_caps_localised_name_mp_cap_unit_cst_inf_deckhands_mob_1	Zombie Pirate Deckhands Mob (Polearms)	false
unit_set_to_mp_unit_caps_localised_name_mp_cap_unit_cst_inf_deckhands_syreens	Syreens	false
unit_set_to_mp_unit_caps_localised_name_mp_cap_unit_cst_inf_depth_guard_0	Depth Guard	false
unit_set_to_mp_unit_caps_localised_name_mp_cap_unit_cst_inf_depth_guard_1	Depth Guard (Polearms)	false
unit_set_to_mp_unit_caps_localised_name_mp_cap_unit_cst_inf_depth_guard_ror_0	The Bloody Reaver Deck Guard	false
unit_set_to_mp_unit_caps_localised_name_mp_cap_unit_cst_inf_fellbats	Fell Bats	false
unit_set_to_mp_unit_caps_localised_name_mp_cap_unit_cst_inf_gunnery_mob_0	Zombie Pirate Gunnery Mob	false
unit_set_to_mp_unit_caps_localised_name_mp_cap_unit_cst_inf_gunnery_mob_1	Zombie Pirate Gunnery Mob (Handguns)	false
unit_set_to_mp_unit_caps_localised_name_mp_cap_unit_cst_inf_gunnery_mob_2	Zombie Pirate Gunnery Mob (Handcannons)	false
unit_set_to_mp_unit_caps_localised_name_mp_cap_unit_cst_inf_gunnery_mob_3	Zombie Pirate Gunnery Mob (Bombers	false
unit_set_to_mp_unit_caps_localised_name_mp_cap_unit_cst_inf_sartosa_free_company	Sartosa Free Company	false
unit_set_to_mp_unit_caps_localised_name_mp_cap_unit_cst_inf_sartosa_militia	Sartosa Militia	false
unit_set_to_mp_unit_caps_localised_name_mp_cap_unit_cst_inf_scurvy_dogs	Scurvy Dogs	false
unit_set_to_mp_unit_caps_localised_name_mp_cap_unit_cst_inf_zombie_deckhands_mob_ror_0	The Tide of Skjold	false
unit_set_to_mp_unit_caps_localised_name_mp_cap_unit_cst_inf_zombie_gunnery_mob_ror_0	The Black Spot	false
unit_set_to_mp_unit_caps_localised_name_mp_cap_unit_cst_mon_animated_hulks	Animated Hulks	false
unit_set_to_mp_unit_caps_localised_name_mp_cap_unit_cst_mon_bloated_corpse	Bloated Corpse	false
unit_set_to_mp_unit_caps_localised_name_mp_cap_unit_cst_mon_mournguls	Mournguls	false
unit_set_to_mp_unit_caps_localised_name_mp_cap_unit_cst_mon_mournguls_ror_0	Night Terrors	false
unit_set_to_mp_unit_caps_localised_name_mp_cap_unit_cst_mon_necrofex_colossus	Necrofex Colossus	false
unit_set_to_mp_unit_caps_localised_name_mp_cap_unit_cst_mon_necrofex_colossus_ror_0	Gallows Giant	false
unit_set_to_mp_unit_caps_localised_name_mp_cap_unit_cst_mon_rotting_leviathan	Rotting Leviathan	false
unit_set_to_mp_unit_caps_localised_name_mp_cap_unit_cst_mon_rotting_promethean_gunnery_mob_0	Rotting Promethean Gunnery Mob	false
unit_set_to_mp_unit_caps_localised_name_mp_cap_unit_cst_mon_rotting_prometheans	Rotting Prometheans	false
unit_set_to_mp_unit_caps_localised_name_mp_cap_unit_cst_mon_rotting_prometheans_gunnery_mob_ror	The Lamprey's Revenge	false
unit_set_to_mp_unit_caps_localised_name_mp_cap_unit_cst_mon_terrorgheist	Death Shriek Terrorgheist	false
unit_set_to_mp_unit_caps_localised_name_mp_cap_unit_cth_art_fire_rain_rocket_battery_0	Fire Rain Rocket	false
unit_set_to_mp_unit_caps_localised_name_mp_cap_unit_cth_art_grand_cannon_0	Grand Cannon	false
unit_set_to_mp_unit_caps_localised_name_mp_cap_unit_cth_cav_jade_lancers_0	Jade Lancers	false
unit_set_to_mp_unit_caps_localised_name_mp_cap_unit_cth_cav_jade_longma_riders_0	Great Longma Riders	false
unit_set_to_mp_unit_caps_localised_name_mp_cap_unit_cth_cav_jade_longma_riders_ror_0	Righteous Lances of Wei-Jin	false
unit_set_to_mp_unit_caps_localised_name_mp_cap_unit_cth_cav_peasant_horsemen_0	Peasant Horsemen	false
unit_set_to_mp_unit_caps_localised_name_mp_cap_unit_cth_inf_crane_gunners_0	Crane Gunners	false
unit_set_to_mp_unit_caps_localised_name_mp_cap_unit_cth_inf_dragon_guard_0	Celestial Dragon Guard	false
unit_set_to_mp_unit_caps_localised_name_mp_cap_unit_cth_inf_dragon_guard_crossbowmen_0	Celestial Dragon Crossbows	false
unit_set_to_mp_unit_caps_localised_name_mp_cap_unit_cth_inf_dragon_guard_crossbowmen_ror	The Grace of Quai Yin	false
unit_set_to_mp_unit_caps_localised_name_mp_cap_unit_cth_inf_dragon_guard_ror_0	The Dune Dragons	false
unit_set_to_mp_unit_caps_localised_name_mp_cap_unit_cth_inf_grenadiers	{{tr:land_units_onscreen_name_wh3_main_cth_inf_grenadiers}}	false
unit_set_to_mp_unit_caps_localised_name_mp_cap_unit_cth_inf_iron_hail_gunners_0	Iron Hail Gunners	false
unit_set_to_mp_unit_caps_localised_name_mp_cap_unit_cth_inf_jade_warrior_crossbowmen_0	Jade Warrior Crossbows	false
unit_set_to_mp_unit_caps_localised_name_mp_cap_unit_cth_inf_jade_warrior_crossbowmen_1	Jade Warrior Crossbows (Shields)	false
unit_set_to_mp_unit_caps_localised_name_mp_cap_unit_cth_inf_jade_warriors_0	Jade Warriors	false
unit_set_to_mp_unit_caps_localised_name_mp_cap_unit_cth_inf_jade_warriors_1	Jade Warriors (Halberds)	false
unit_set_to_mp_unit_caps_localised_name_mp_cap_unit_cth_inf_onyx_crowmen	Onyx Crowmen	false
unit_set_to_mp_unit_caps_localised_name_mp_cap_unit_cth_inf_onyx_crowmen_ror	Empress Crowmen	false
unit_set_to_mp_unit_caps_localised_name_mp_cap_unit_cth_inf_peasant_archers_0	Peasant Archers	false
unit_set_to_mp_unit_caps_localised_name_mp_cap_unit_cth_inf_peasant_archers_ror	Bandits of the Silver Road	false
unit_set_to_mp_unit_caps_localised_name_mp_cap_unit_cth_inf_peasant_spearmen_1	Peasant Spearmen	false
unit_set_to_mp_unit_caps_localised_name_mp_cap_unit_cth_mon_terracotta_sentinel_0	Terracotta Sentinel	false
unit_set_to_mp_unit_caps_localised_name_mp_cap_unit_cth_mon_terracotta_sentinel_0_ror	The Green Guardian (Terracotta Sentinel)	false
unit_set_to_mp_unit_caps_localised_name_mp_cap_unit_cth_veh_sky_junk_0	Sky-junk	false
unit_set_to_mp_unit_caps_localised_name_mp_cap_unit_cth_veh_sky_lantern_0	Sky Lantern	false
unit_set_to_mp_unit_caps_localised_name_mp_cap_unit_cth_veh_war_compass_0	Wu Xing War Compass	false
unit_set_to_mp_unit_caps_localised_name_mp_cap_unit_cth_veh_zhangu_war_drum	Zhangu War Drum	false
unit_set_to_mp_unit_caps_localised_name_mp_cap_unit_cth_veh_zhangu_war_drum_ror	The Jade War Drum	false
unit_set_to_mp_unit_caps_localised_name_mp_cap_unit_dae_inf_chaos_furies_0	Chaos Furies	false
unit_set_to_mp_unit_caps_localised_name_mp_cap_unit_def_art_reaver_bolt_thrower	Reaper Bolt Thrower	false
unit_set_to_mp_unit_caps_localised_name_mp_cap_unit_def_cav_cold_one_chariot	Cold One Chariots	false
unit_set_to_mp_unit_caps_localised_name_mp_cap_unit_def_cav_cold_one_dread_knights	Cold One Dread Knights	false
unit_set_to_mp_unit_caps_localised_name_mp_cap_unit_def_cav_cold_one_knights	Cold One Knights	false
unit_set_to_mp_unit_caps_localised_name_mp_cap_unit_def_cav_dark_riders_0	Dark Riders	false
unit_set_to_mp_unit_caps_localised_name_mp_cap_unit_def_cav_dark_riders_1	Dark Riders (Shields)	false
unit_set_to_mp_unit_caps_localised_name_mp_cap_unit_def_cav_dark_riders_2	Dark Riders (Repeater Crossbow)	false
unit_set_to_mp_unit_caps_localised_name_mp_cap_unit_def_cav_doomfire_warlocks	Doomfire Warlocks	false
unit_set_to_mp_unit_caps_localised_name_mp_cap_unit_def_cav_knights_of_the_ebon_claw_ror_0	Knights of the Ebon Claw	false
unit_set_to_mp_unit_caps_localised_name_mp_cap_unit_def_cav_raven_heralds_ror_0	Raven Heralds	false
unit_set_to_mp_unit_caps_localised_name_mp_cap_unit_def_cav_scourgerunner_chariot	Scourgerunner Chariot	false
unit_set_to_mp_unit_caps_localised_name_mp_cap_unit_def_cav_scourgerunner_chariot_ror	Ravagers of Rakarth	false
unit_set_to_mp_unit_caps_localised_name_mp_cap_unit_def_cav_slaanesh_harvesters_ror_0	Slaanesh's Harvesters	false
unit_set_to_mp_unit_caps_localised_name_mp_cap_unit_def_inf_black_ark_corsairs_0	Black Ark Corsairs	false
unit_set_to_mp_unit_caps_localised_name_mp_cap_unit_def_inf_black_ark_corsairs_1	Black Ark Corsairs (Handbows)	false
unit_set_to_mp_unit_caps_localised_name_mp_cap_unit_def_inf_black_guard	Black Guard of Naggarond	false
unit_set_to_mp_unit_caps_localised_name_mp_cap_unit_def_inf_blades_of_the_blood_queen_ror_0	Blades of the Blood Queen	false
unit_set_to_mp_unit_caps_localised_name_mp_cap_unit_def_inf_bleakswords	Bleakswords	false
unit_set_to_mp_unit_caps_localised_name_mp_cap_unit_def_inf_darkshards_0	Darkshards	false
unit_set_to_mp_unit_caps_localised_name_mp_cap_unit_def_inf_darkshards_1	Darkshards (Shields)	false
unit_set_to_mp_unit_caps_localised_name_mp_cap_unit_def_inf_dreadspears	Dreadspears	false
unit_set_to_mp_unit_caps_localised_name_mp_cap_unit_def_inf_har_ganeth_executioners	Har Ganeth Executioner	false
unit_set_to_mp_unit_caps_localised_name_mp_cap_unit_def_inf_harpies_ror	The Crows of Khaine	false
unit_set_to_mp_unit_caps_localised_name_mp_cap_unit_def_inf_shades	Shades	false
unit_set_to_mp_unit_caps_localised_name_mp_cap_unit_def_inf_sisters_of_slaughter	Sisters of Slaughter	false
unit_set_to_mp_unit_caps_localised_name_mp_cap_unit_def_inf_sisters_of_the_singing_doom_ror_0	Sisters of the Singing Doom	false
unit_set_to_mp_unit_caps_localised_name_mp_cap_unit_def_inf_the_bolt_fiends_ror_0	The Bolt-Fiends	false
unit_set_to_mp_unit_caps_localised_name_mp_cap_unit_def_inf_the_hellebronai_ror_0	The Hellebronai	false
unit_set_to_mp_unit_caps_localised_name_mp_cap_unit_def_inf_witch_elves	Witch Elves	false
unit_set_to_mp_unit_caps_localised_name_mp_cap_unit_def_mon_black_dragon	Black Dragon	false
unit_set_to_mp_unit_caps_localised_name_mp_cap_unit_def_mon_bloodwrack_medusa	Bloodwrack Medusae	false
unit_set_to_mp_unit_caps_localised_name_mp_cap_unit_def_mon_bloodwrack_medusa_ror	The Siren of Red Ruin	false
unit_set_to_mp_unit_caps_localised_name_mp_cap_unit_def_mon_chill_of_sontar_ror_0	Chill of Sontar	false
unit_set_to_mp_unit_caps_localised_name_mp_cap_unit_def_mon_feral_manticore	Feral Manticore	false
unit_set_to_mp_unit_caps_localised_name_mp_cap_unit_def_mon_harpies	Harpies	false
unit_set_to_mp_unit_caps_localised_name_mp_cap_unit_def_mon_kharibdyss	Kharibdyss	false
unit_set_to_mp_unit_caps_localised_name_mp_cap_unit_def_mon_war_hydra	War Hydra	false
unit_set_to_mp_unit_caps_localised_name_mp_cap_unit_def_veh_bloodwrack_shrine_0	Bloodwrack Shrine	false
unit_set_to_mp_unit_caps_localised_name_mp_cap_unit_def_veh_cold_one_chariot	Cold One Chariots	false
unit_set_to_mp_unit_caps_localised_name_mp_cap_unit_dwf_art_bolt_thrower	Bolt Thrower	false
unit_set_to_mp_unit_caps_localised_name_mp_cap_unit_dwf_art_cannon	Cannon	false
unit_set_to_mp_unit_caps_localised_name_mp_cap_unit_dwf_art_flame_cannon	Flame Cannon	false
unit_set_to_mp_unit_caps_localised_name_mp_cap_unit_dwf_art_gob_lobber_0	Gob-Lobber	false
unit_set_to_mp_unit_caps_localised_name_mp_cap_unit_dwf_art_goblin_hewer	{{tr:land_units_onscreen_name_wh3_dlc25_dwf_art_goblin_hewer}}	false
unit_set_to_mp_unit_caps_localised_name_mp_cap_unit_dwf_art_grudge_thrower	Grudge Thrower	false
unit_set_to_mp_unit_caps_localised_name_mp_cap_unit_dwf_art_organ_gun	Organ Gun	false
unit_set_to_mp_unit_caps_localised_name_mp_cap_unit_dwf_cha_master_engineer_ghost_0	Dramar Hammerfist	false
unit_set_to_mp_unit_caps_localised_name_mp_cap_unit_dwf_cha_rune_casters	Rune Caster	false
unit_set_to_mp_unit_caps_localised_name_mp_cap_unit_dwf_cha_runesmith_ghost_0	Throni Ironbrow 	false
unit_set_to_mp_unit_caps_localised_name_mp_cap_unit_dwf_cha_thane_ghost_0	King Lunn Ironhammer 	false
unit_set_to_mp_unit_caps_localised_name_mp_cap_unit_dwf_cha_thane_ghost_1	Halkenhaf Stonebeard	false
unit_set_to_mp_unit_caps_localised_name_mp_cap_unit_dwf_inf_bugmans_rangers_0	Bugman's Rangers	false
unit_set_to_mp_unit_caps_localised_name_mp_cap_unit_dwf_inf_doomseekers	{{tr:land_units_onscreen_name_wh3_dlc25_dwf_inf_doomseekers}}	false
unit_set_to_mp_unit_caps_localised_name_mp_cap_unit_dwf_inf_doomseekers_ror	{{tr:land_units_onscreen_name_wh3_dlc25_dwf_inf_doomseekers_ror}}	false
unit_set_to_mp_unit_caps_localised_name_mp_cap_unit_dwf_inf_dragonback_slayers_0	Dragonback Slayers	false
unit_set_to_mp_unit_caps_localised_name_mp_cap_unit_dwf_inf_dwarf_warriors_0	Dwarf Warriors	false
unit_set_to_mp_unit_caps_localised_name_mp_cap_unit_dwf_inf_dwarf_warriors_1	Dwarf Warriors (Great Weapons)	false
unit_set_to_mp_unit_caps_localised_name_mp_cap_unit_dwf_inf_ekrund_miners_0	Ekrund Miners	false
unit_set_to_mp_unit_caps_localised_name_mp_cap_unit_dwf_inf_giant_slayers_0	Giant Slayers	false
unit_set_to_mp_unit_caps_localised_name_mp_cap_unit_dwf_inf_hammerers_0	Hammerers	false
unit_set_to_mp_unit_caps_localised_name_mp_cap_unit_dwf_inf_ironbreakers_0	Ironbreakers	false
unit_set_to_mp_unit_caps_localised_name_mp_cap_unit_dwf_inf_irondrakes_0	Irondrakes	false
unit_set_to_mp_unit_caps_localised_name_mp_cap_unit_dwf_inf_irondrakes_1	Irondrakes (Trollhammer Torpedoes)	false
unit_set_to_mp_unit_caps_localised_name_mp_cap_unit_dwf_inf_longbeards_0	Longbeards	false
unit_set_to_mp_unit_caps_localised_name_mp_cap_unit_dwf_inf_longbeards_1	Longbeards (Great Weapons)	false
unit_set_to_mp_unit_caps_localised_name_mp_cap_unit_dwf_inf_miners_0	Miners	false
unit_set_to_mp_unit_caps_localised_name_mp_cap_unit_dwf_inf_miners_1	Miners (Blasting Charges)	false
unit_set_to_mp_unit_caps_localised_name_mp_cap_unit_dwf_inf_mp_cap_warriors_dragonfire_pass_0	Warriors of Dragonfire Pass	false
unit_set_to_mp_unit_caps_localised_name_mp_cap_unit_dwf_inf_norgrimlings_ironbreakers_0	Norgrimlings Ironbreakers	false
unit_set_to_mp_unit_caps_localised_name_mp_cap_unit_dwf_inf_norgrimlings_irondrakes_0	The Skolder Guard	false
unit_set_to_mp_unit_caps_localised_name_mp_cap_unit_dwf_inf_old_grumblers_0	The Grumbling Guard	false
unit_set_to_mp_unit_caps_localised_name_mp_cap_unit_dwf_inf_peak_gate_guard_0	Peak Gate Guard	false
unit_set_to_mp_unit_caps_localised_name_mp_cap_unit_dwf_inf_quarrellers_0	Quarrellers	false
unit_set_to_mp_unit_caps_localised_name_mp_cap_unit_dwf_inf_quarrellers_1	Quarrellers (Great Weapons)	false
unit_set_to_mp_unit_caps_localised_name_mp_cap_unit_dwf_inf_rangers_0	Rangers	false
unit_set_to_mp_unit_caps_localised_name_mp_cap_unit_dwf_inf_rangers_1	Rangers (Great Weapons)	false
unit_set_to_mp_unit_caps_localised_name_mp_cap_unit_dwf_inf_slayer_pirates	{{tr:land_units_onscreen_name_wh3_dlc25_dwf_inf_slayer_pirates}}	false
unit_set_to_mp_unit_caps_localised_name_mp_cap_unit_dwf_inf_slayer_pirates_ror	{{tr:land_units_onscreen_name_wh3_dlc25_dwf_inf_slayer_pirates_ror}}	false
unit_set_to_mp_unit_caps_localised_name_mp_cap_unit_dwf_inf_slayers_0	Slayers	false
unit_set_to_mp_unit_caps_localised_name_mp_cap_unit_dwf_inf_thunderers_0	Thunderers	false
unit_set_to_mp_unit_caps_localised_name_mp_cap_unit_dwf_inf_thunderers_grudge_rakers	{{tr:land_units_onscreen_name_wh3_dlc25_dwf_inf_thunderers_grudge_rakers}}	false
unit_set_to_mp_unit_caps_localised_name_mp_cap_unit_dwf_inf_thunderers_ror	{{tr:land_units_onscreen_name_wh3_dlc25_dwf_inf_thunderers_ror}}	false
unit_set_to_mp_unit_caps_localised_name_mp_cap_unit_dwf_inf_ulthars_raiders_0	Ulthar's Raiders	false
unit_set_to_mp_unit_caps_localised_name_mp_cap_unit_dwf_veh_gyrobomber_0	Gyrobomber	false
unit_set_to_mp_unit_caps_localised_name_mp_cap_unit_dwf_veh_gyrocopter_0	Gyrocopter	false
unit_set_to_mp_unit_caps_localised_name_mp_cap_unit_dwf_veh_gyrocopter_1	Gyrocopter (Brimstone Guns)	false
unit_set_to_mp_unit_caps_localised_name_mp_cap_unit_dwf_veh_skyhammer_0	Skyhammer	false
unit_set_to_mp_unit_caps_localised_name_mp_cap_unit_dwf_veh_thunderbarge	{{tr:land_units_onscreen_name_wh3_dlc25_dwf_veh_thunderbarge}}	false
unit_set_to_mp_unit_caps_localised_name_mp_cap_unit_emp_art_great_cannon	Great Cannon	false
unit_set_to_mp_unit_caps_localised_name_mp_cap_unit_emp_art_hammer_of_the_witches_0	Hammer of the Witches	false
unit_set_to_mp_unit_caps_localised_name_mp_cap_unit_emp_art_helblaster_volley_gun	Helblaster Volley Gun	false
unit_set_to_mp_unit_caps_localised_name_mp_cap_unit_emp_art_helstorm_rocket_battery	Helstorm Rocket Battery	false
unit_set_to_mp_unit_caps_localised_name_mp_cap_unit_emp_art_mortar	Mortar	false
unit_set_to_mp_unit_caps_localised_name_mp_cap_unit_emp_art_sunmaker_0	Sunmaker	false
unit_set_to_mp_unit_caps_localised_name_mp_cap_unit_emp_cav_demigryph_knights_0	Demigryph Knights	false
unit_set_to_mp_unit_caps_localised_name_mp_cap_unit_emp_cav_demigryph_knights_1	Demigryph Knights (Halberds)	false
unit_set_to_mp_unit_caps_localised_name_mp_cap_unit_emp_cav_empire_knights	Empire Knights	false
unit_set_to_mp_unit_caps_localised_name_mp_cap_unit_emp_cav_knights_of_the_black_rose	{{tr:land_units_onscreen_name_wh3_dlc25_emp_cav_knights_of_the_black_rose}}	false
unit_set_to_mp_unit_caps_localised_name_mp_cap_unit_emp_cav_knights_of_the_blazing_sun	Knights of the Blazing Sun	false
unit_set_to_mp_unit_caps_localised_name_mp_cap_unit_emp_cav_outriders_0	Outriders	false
unit_set_to_mp_unit_caps_localised_name_mp_cap_unit_emp_cav_outriders_1	Outriders (Grenade Launchers)	false
unit_set_to_mp_unit_caps_localised_name_mp_cap_unit_emp_cav_pistoliers	Pistoliers	false
unit_set_to_mp_unit_caps_localised_name_mp_cap_unit_emp_cav_reiksguard	Reiksguard	false
unit_set_to_mp_unit_caps_localised_name_mp_cap_unit_emp_cav_royal_altdorf_gryphites_0	Royal Altdorf Gryphites	false
unit_set_to_mp_unit_caps_localised_name_mp_cap_unit_emp_cav_zintlers_reiksguard_0	Zintler's Reiksguard	false
unit_set_to_mp_unit_caps_localised_name_mp_cap_unit_emp_inf_archers	Archers	false
unit_set_to_mp_unit_caps_localised_name_mp_cap_unit_emp_inf_archers_ror_0	Deathjacks	false
unit_set_to_mp_unit_caps_localised_name_mp_cap_unit_emp_inf_crossbowmen	Crossbowmen	false
unit_set_to_mp_unit_caps_localised_name_mp_cap_unit_emp_inf_flagellants_0	Flagellants	false
unit_set_to_mp_unit_caps_localised_name_mp_cap_unit_emp_inf_free_company_militia	Free Company Militia	false
unit_set_to_mp_unit_caps_localised_name_mp_cap_unit_emp_inf_greatswords	Greatswords	false
unit_set_to_mp_unit_caps_localised_name_mp_cap_unit_emp_inf_halberdiers	Halberdiers	false
unit_set_to_mp_unit_caps_localised_name_mp_cap_unit_emp_inf_handgunners	Handgunners	false
unit_set_to_mp_unit_caps_localised_name_mp_cap_unit_emp_inf_hochland_long_rifles	{{tr:land_units_onscreen_name_wh3_dlc25_emp_inf_hochland_long_rifles}}	false
unit_set_to_mp_unit_caps_localised_name_mp_cap_unit_emp_inf_hochland_long_rifles_ror	{{tr:land_units_onscreen_name_wh3_dlc25_emp_inf_hochland_long_rifles_ror}}	false
unit_set_to_mp_unit_caps_localised_name_mp_cap_unit_emp_inf_huntsmen	Huntsmen	false
unit_set_to_mp_unit_caps_localised_name_mp_cap_unit_emp_inf_huntsmen_ror_0	The White Wolves	false
unit_set_to_mp_unit_caps_localised_name_mp_cap_unit_emp_inf_nuln_ironsides	{{tr:land_units_onscreen_name_wh3_dlc25_emp_inf_nuln_ironsides}}	false
unit_set_to_mp_unit_caps_localised_name_mp_cap_unit_emp_inf_sigmars_sons_0	Sigmar's Sons	false
unit_set_to_mp_unit_caps_localised_name_mp_cap_unit_emp_inf_silver_bullets_0	Silver Bullets	false
unit_set_to_mp_unit_caps_localised_name_mp_cap_unit_emp_inf_spearmen_0	Spearmen	false
unit_set_to_mp_unit_caps_localised_name_mp_cap_unit_emp_inf_spearmen_1	Spearmen (Shields)	false
unit_set_to_mp_unit_caps_localised_name_mp_cap_unit_emp_inf_spearmen_shields_ror	{{tr:land_units_onscreen_name_wh3_dlc25_emp_inf_spearmen_shields_ror}}	false
unit_set_to_mp_unit_caps_localised_name_mp_cap_unit_emp_inf_stirlands_revenge_0	Stirland's Revenge	false
unit_set_to_mp_unit_caps_localised_name_mp_cap_unit_emp_inf_swordsmen_0	Swordsmen	false
unit_set_to_mp_unit_caps_localised_name_mp_cap_unit_emp_inf_swordsmen_ror_0	Swords of Ulric	false
unit_set_to_mp_unit_caps_localised_name_mp_cap_unit_emp_inf_tattersouls_0	Tattersouls	false
unit_set_to_mp_unit_caps_localised_name_mp_cap_unit_emp_veh_luminark_of_hysh	Luminark of Hysh	false
unit_set_to_mp_unit_caps_localised_name_mp_cap_unit_emp_veh_marienburg_land_ship	{{tr:land_units_onscreen_name_wh3_dlc25_emp_veh_marienburg_land_ship}}	false
unit_set_to_mp_unit_caps_localised_name_mp_cap_unit_emp_veh_marienburg_land_ship_ror	{{tr:land_units_onscreen_name_wh3_dlc25_emp_veh_marienburg_land_ship_ror}}	false
unit_set_to_mp_unit_caps_localised_name_mp_cap_unit_emp_veh_steam_tank	Steam Tank	false
unit_set_to_mp_unit_caps_localised_name_mp_cap_unit_emp_veh_templehof_luminark_0	Templehof Luminark	false
unit_set_to_mp_unit_caps_localised_name_mp_cap_unit_emp_veh_war_wagon_0	War Wagon	false
unit_set_to_mp_unit_caps_localised_name_mp_cap_unit_emp_veh_war_wagon_1	War Wagon (Mortar)	false
unit_set_to_mp_unit_caps_localised_name_mp_cap_unit_emp_veh_war_wagon_ror_0	The Black Lions	false
unit_set_to_mp_unit_caps_localised_name_mp_cap_unit_grn_art_bolt_throwa	{{tr:land_units_onscreen_name_wh3_dlc26_grn_art_bolt_throwa}}	false
unit_set_to_mp_unit_caps_localised_name_mp_cap_unit_grn_art_bolt_throwa_ror	{{tr:land_units_onscreen_name_wh3_dlc26_grn_art_bolt_throwa_ror}}	false
unit_set_to_mp_unit_caps_localised_name_mp_cap_unit_grn_art_doom_diver_catapult	Doom Diver Catapults	false
unit_set_to_mp_unit_caps_localised_name_mp_cap_unit_grn_art_hammer_of_gork_0	Hammer of Gork	false
unit_set_to_mp_unit_caps_localised_name_mp_cap_unit_grn_art_rock_lobber	Goblin Rock Lobber	false
unit_set_to_mp_unit_caps_localised_name_mp_cap_unit_grn_cav_broken_tusks_mob_0	Broken Tusks Mob	false
unit_set_to_mp_unit_caps_localised_name_mp_cap_unit_grn_cav_deff_creepers_0	Deff Creepers	false
unit_set_to_mp_unit_caps_localised_name_mp_cap_unit_grn_cav_durkits_squigs_0	Durkit's Squigs	false
unit_set_to_mp_unit_caps_localised_name_mp_cap_unit_grn_cav_fores_goblin_spider_rider_archers	Forest Goblin Spider Rider Archers	false
unit_set_to_mp_unit_caps_localised_name_mp_cap_unit_grn_cav_forest_goblin_spider_riders	Forest Goblin Spider Rider	false
unit_set_to_mp_unit_caps_localised_name_mp_cap_unit_grn_cav_goblin_wolf_rider_archers	Goblin Wolf Rider Archers	false
unit_set_to_mp_unit_caps_localised_name_mp_cap_unit_grn_cav_goblin_wolf_riders	Goblin Wolf Riders	false
unit_set_to_mp_unit_caps_localised_name_mp_cap_unit_grn_cav_mogrubbs_marauders_0	Mogrubb's Mangy Marauders	false
unit_set_to_mp_unit_caps_localised_name_mp_cap_unit_grn_cav_moon_howlers_0	Moon-Howlers	false
unit_set_to_mp_unit_caps_localised_name_mp_cap_unit_grn_cav_night_goblin_squig_hoppers	Night Goblin Squig Hoppers	false
unit_set_to_mp_unit_caps_localised_name_mp_cap_unit_grn_cav_orc_boar_boyz	Orc Boar Boyz	false
unit_set_to_mp_unit_caps_localised_name_mp_cap_unit_grn_cav_orc_boar_boyz_big_uns	Orc Boar Boy Big 'Uns	false
unit_set_to_mp_unit_caps_localised_name_mp_cap_unit_grn_cav_savage_orc_boar_boyz	Savage Orc Boar Boyz	false
unit_set_to_mp_unit_caps_localised_name_mp_cap_unit_grn_cav_savage_orc_boar_boyz_big_uns	Savage Orc Boar Boy Big 'Uns	false
unit_set_to_mp_unit_caps_localised_name_mp_cap_unit_grn_cav_teef_robbers_0	Teef-Robbers	false
unit_set_to_mp_unit_caps_localised_name_mp_cap_unit_grn_inf_black_orcs	Black Orcs	false
unit_set_to_mp_unit_caps_localised_name_mp_cap_unit_grn_inf_da_eight_peaks_loonies_0	Da Eight Peak Loonies	false
unit_set_to_mp_unit_caps_localised_name_mp_cap_unit_grn_inf_da_rusty_arrers_0	Da Rusty Arrers	false
unit_set_to_mp_unit_caps_localised_name_mp_cap_unit_grn_inf_da_warlords_boyz_0	Da Warlord's Boyz	false
unit_set_to_mp_unit_caps_localised_name_mp_cap_unit_grn_inf_goblin_archers	Goblin Archers	false
unit_set_to_mp_unit_caps_localised_name_mp_cap_unit_grn_inf_goblins	Goblins	false
unit_set_to_mp_unit_caps_localised_name_mp_cap_unit_grn_inf_goblins_spearmen	Goblins (Spears)	false
unit_set_to_mp_unit_caps_localised_name_mp_cap_unit_grn_inf_krimson_killerz_0	Krimson Killerz	false
unit_set_to_mp_unit_caps_localised_name_mp_cap_unit_grn_inf_nasty_skulkers	Nasty Skulkers	false
unit_set_to_mp_unit_caps_localised_name_mp_cap_unit_grn_inf_night_goblin_archers	Night Goblin Archers	false
unit_set_to_mp_unit_caps_localised_name_mp_cap_unit_grn_inf_night_goblin_archers_fanatics	Night Goblin Archers (Fanatics)	false
unit_set_to_mp_unit_caps_localised_name_mp_cap_unit_grn_inf_night_goblins	Night Goblins	false
unit_set_to_mp_unit_caps_localised_name_mp_cap_unit_grn_inf_night_goblins_fanatics	Night Goblins (Fanatics)	false
unit_set_to_mp_unit_caps_localised_name_mp_cap_unit_grn_inf_orc_arrer_boyz	Orc Arrer Boyz	false
unit_set_to_mp_unit_caps_localised_name_mp_cap_unit_grn_inf_orc_boyz	Orc Boyz	false
unit_set_to_mp_unit_caps_localised_name_mp_cap_unit_grn_inf_orc_boyz_big_uns	Orc Big 'Uns	false
unit_set_to_mp_unit_caps_localised_name_mp_cap_unit_grn_inf_orc_boyz_spears	Orc Boyz (Spears)	false
unit_set_to_mp_unit_caps_localised_name_mp_cap_unit_grn_inf_rugluds_armoured_orcs	Ruglud's Armoured Orcs	false
unit_set_to_mp_unit_caps_localised_name_mp_cap_unit_grn_inf_savage_orc_arrer_boyz	Savage Orc Arrer Boyz	false
unit_set_to_mp_unit_caps_localised_name_mp_cap_unit_grn_inf_savage_orc_boyz_big_uns	Savage Orc Big 'Uns	false
unit_set_to_mp_unit_caps_localised_name_mp_cap_unit_grn_inf_savage_orcs	Savage Orcs	false
unit_set_to_mp_unit_caps_localised_name_mp_cap_unit_grn_mon_arachnarok_spider	Arachnarok Spider	false
unit_set_to_mp_unit_caps_localised_name_mp_cap_unit_grn_mon_colossal_squig	Colossal Squig	false
unit_set_to_mp_unit_caps_localised_name_mp_cap_unit_grn_mon_colossal_squig_ror	{{tr:land_units_onscreen_name_wh3_dlc26_grn_mon_colossal_squig_ror}}	false
unit_set_to_mp_unit_caps_localised_name_mp_cap_unit_grn_mon_feral_wyvern	{{tr:land_units_onscreen_name_wh2_dlc15_grn_mon_wyvern_waaagh_0}}	false
unit_set_to_mp_unit_caps_localised_name_mp_cap_unit_grn_mon_giant	Giant	false
unit_set_to_mp_unit_caps_localised_name_mp_cap_unit_grn_mon_mangler_squig	Mangler Squigs	false
unit_set_to_mp_unit_caps_localised_name_mp_cap_unit_grn_mon_river_trolls	River Trolls	false
unit_set_to_mp_unit_caps_localised_name_mp_cap_unit_grn_mon_river_trolls_ror_0	Da Swamp Fings	false
unit_set_to_mp_unit_caps_localised_name_mp_cap_unit_grn_mon_rogue_idol	Rogue Idols	false
unit_set_to_mp_unit_caps_localised_name_mp_cap_unit_grn_mon_rogue_idol_ror_0	Da Big Un	false
unit_set_to_mp_unit_caps_localised_name_mp_cap_unit_grn_mon_squig_herd	Squig Herd	false
unit_set_to_mp_unit_caps_localised_name_mp_cap_unit_grn_mon_stone_trolls	Stone Trolls	false
unit_set_to_mp_unit_caps_localised_name_mp_cap_unit_grn_mon_trolls	Trolls	false
unit_set_to_mp_unit_caps_localised_name_mp_cap_unit_grn_mon_venom_queen_0	The Arachnarok Queen	false
unit_set_to_mp_unit_caps_localised_name_mp_cap_unit_grn_veh_goblin_wolf_chariot	Goblin Wolf Chariots	false
unit_set_to_mp_unit_caps_localised_name_mp_cap_unit_grn_veh_orc_boar_chariot	Orc Boar Chariots	false
unit_set_to_mp_unit_caps_localised_name_mp_cap_unit_grn_veh_pump_wagons	Snotling Pump Wagons	false
unit_set_to_mp_unit_caps_localised_name_mp_cap_unit_grn_veh_snotling_pump_wagon_ror_0	Logey Bogey’s Spore ‘Splodaz	false
unit_set_to_mp_unit_caps_localised_name_mp_cap_unit_hef_art_eagle_claw_bolt_thrower	Eagle Claw Bolt Thrower	false
unit_set_to_mp_unit_caps_localised_name_mp_cap_unit_hef_cav_dragon_princes	Dragon Princes	false
unit_set_to_mp_unit_caps_localised_name_mp_cap_unit_hef_cav_ellyrian_reaver_archers	Ellyrian Reaver Archers	false
unit_set_to_mp_unit_caps_localised_name_mp_cap_unit_hef_cav_ellyrian_reavers	Ellyrian Reavers	false
unit_set_to_mp_unit_caps_localised_name_mp_cap_unit_hef_cav_silver_helms	Silver Helms	false
unit_set_to_mp_unit_caps_localised_name_mp_cap_unit_hef_cav_silver_helms_shields	Silver Helm (Shields)	false
unit_set_to_mp_unit_caps_localised_name_mp_cap_unit_hef_cav_the_fireborn_ror_0	The Fireborn	false
unit_set_to_mp_unit_caps_localised_name_mp_cap_unit_hef_cav_the_heralds_of_the_wind_ror_0	Heralds of the Wind 	false
unit_set_to_mp_unit_caps_localised_name_mp_cap_unit_hef_inf_archers	Archers	false
unit_set_to_mp_unit_caps_localised_name_mp_cap_unit_hef_inf_archers_1	Archers (Light Armour)	false
unit_set_to_mp_unit_caps_localised_name_mp_cap_unit_hef_inf_archers_ror_0	Talons of Tor Caleda	false
unit_set_to_mp_unit_caps_localised_name_mp_cap_unit_hef_inf_everqueens_court_guards_ror_0	Everqueen's Court Guards	false
unit_set_to_mp_unit_caps_localised_name_mp_cap_unit_hef_inf_keepers_of_the_flame_ror_0	Keepers of the Flame	false
unit_set_to_mp_unit_caps_localised_name_mp_cap_unit_hef_inf_lothern_sea_guard	Lothern Sea Guard	false
unit_set_to_mp_unit_caps_localised_name_mp_cap_unit_hef_inf_lothern_sea_guard_shields	Lothern Sea Guard (Shields)	false
unit_set_to_mp_unit_caps_localised_name_mp_cap_unit_hef_inf_phoenix_guard	Phoenix Guard	false
unit_set_to_mp_unit_caps_localised_name_mp_cap_unit_hef_inf_rangers	Rangers	false
unit_set_to_mp_unit_caps_localised_name_mp_cap_unit_hef_inf_shadow_walkers	Shadow Walkers	false
unit_set_to_mp_unit_caps_localised_name_mp_cap_unit_hef_inf_shadow_warriors	Shadow Warriors	false
unit_set_to_mp_unit_caps_localised_name_mp_cap_unit_hef_inf_silverin_guard	Silverin Guard	false
unit_set_to_mp_unit_caps_localised_name_mp_cap_unit_hef_inf_sisters_of_avelorn	Sisters of Avelorn	false
unit_set_to_mp_unit_caps_localised_name_mp_cap_unit_hef_inf_spearmen	Spearmen	false
unit_set_to_mp_unit_caps_localised_name_mp_cap_unit_hef_inf_swordmasters	Swordmasters of Hoeth	false
unit_set_to_mp_unit_caps_localised_name_mp_cap_unit_hef_inf_the_grey_ror_0	The Grey	false
unit_set_to_mp_unit_caps_localised_name_mp_cap_unit_hef_inf_the_scions_of_mathlann_ror_0	The Scions of Mathlann	false
unit_set_to_mp_unit_caps_localised_name_mp_cap_unit_hef_inf_the_silverpelts_ror_0	The Puremane Company	false
unit_set_to_mp_unit_caps_localised_name_mp_cap_unit_hef_inf_the_storm_riders_ror_0	The Storm Riders	false
unit_set_to_mp_unit_caps_localised_name_mp_cap_unit_hef_inf_white_lions	White Lions of Chrace	false
unit_set_to_mp_unit_caps_localised_name_mp_cap_unit_hef_mon_arcane_phoenix	Arcane Phoenix	false
unit_set_to_mp_unit_caps_localised_name_mp_cap_unit_hef_mon_arcane_phoenix_ror_0	Omen of Asuryan	false
unit_set_to_mp_unit_caps_localised_name_mp_cap_unit_hef_mon_flamespyre_phoenix	Flamespyre Phoenix	false
unit_set_to_mp_unit_caps_localised_name_mp_cap_unit_hef_mon_frostheart_phoenix	Frostheart Phoenix	false
unit_set_to_mp_unit_caps_localised_name_mp_cap_unit_hef_mon_great_eagle	Great Eagle	false
unit_set_to_mp_unit_caps_localised_name_mp_cap_unit_hef_mon_moon_dragon	Moon Dragon	false
unit_set_to_mp_unit_caps_localised_name_mp_cap_unit_hef_mon_star_dragon	Star Dragon	false
unit_set_to_mp_unit_caps_localised_name_mp_cap_unit_hef_mon_sun_dragon	Sun Dragon	false
unit_set_to_mp_unit_caps_localised_name_mp_cap_unit_hef_mon_war_lions	War Lions of Chrace	false
unit_set_to_mp_unit_caps_localised_name_mp_cap_unit_hef_mon_war_lions_of_chrace_ror_0	Rahagra's Pride	false
unit_set_to_mp_unit_caps_localised_name_mp_cap_unit_hef_veh_ithilmar_chariot	Ithilmar Chariots	false
unit_set_to_mp_unit_caps_localised_name_mp_cap_unit_hef_veh_lion_chariot	Lion Chariots of Chrace	false
unit_set_to_mp_unit_caps_localised_name_mp_cap_unit_hef_veh_tiranoc_chariot	Tiranoc Chariots	false
unit_set_to_mp_unit_caps_localised_name_mp_cap_unit_kho_cav_bloodcrushers_0	Bloodcrushers of Khorne	false
unit_set_to_mp_unit_caps_localised_name_mp_cap_unit_kho_cav_bloodcrushers_ror_0	Heralds of Khorne's Fury	false
unit_set_to_mp_unit_caps_localised_name_mp_cap_unit_kho_cav_skullcrushers_0	Skullcrushers of Khorne	false
unit_set_to_mp_unit_caps_localised_name_mp_cap_unit_kho_inf_bloodletters_0	Bloodletters of Khorne	false
unit_set_to_mp_unit_caps_localised_name_mp_cap_unit_kho_inf_bloodletters_1	Exalted Bloodletters of Khorne	false
unit_set_to_mp_unit_caps_localised_name_mp_cap_unit_kho_inf_bloodletters_ror_0	Hellforged Host	false
unit_set_to_mp_unit_caps_localised_name_mp_cap_unit_kho_inf_chaos_furies_0	Chaos Furies of Khorne	false
unit_set_to_mp_unit_caps_localised_name_mp_cap_unit_kho_inf_flesh_hounds_of_khorne_0	Flesh Hounds of Khorne	false
unit_set_to_mp_unit_caps_localised_name_mp_cap_unit_kho_inf_flesh_hounds_of_khorne_ror	Hounds of the Blood Hunt	false
unit_set_to_mp_unit_caps_localised_name_mp_cap_unit_kho_inf_khorngors	Khorngors	false
unit_set_to_mp_unit_caps_localised_name_mp_cap_unit_kho_inf_wrathmongers	Wrathmongers	false
unit_set_to_mp_unit_caps_localised_name_mp_cap_unit_kho_inf_wrathmongers_ror	Bloodstorm Bringers (Wrathmongers)	false
unit_set_to_mp_unit_caps_localised_name_mp_cap_unit_kho_kho_veh_skullcannon_ror	Hellforged Bellowers (Skullcannon)	false
unit_set_to_mp_unit_caps_localised_name_mp_cap_unit_kho_mon_bloodbeast_of_khorne	Bloodbeasts of Khorne	false
unit_set_to_mp_unit_caps_localised_name_mp_cap_unit_kho_mon_bloodthirster_0	Bloodthirster	false
unit_set_to_mp_unit_caps_localised_name_mp_cap_unit_kho_mon_bloodthirster_0_ror	Khorne’s Bloody Fist (Bloodthirster)	false
unit_set_to_mp_unit_caps_localised_name_mp_cap_unit_kho_mon_khornataurs_0	Minotaurs of Khorne	false
unit_set_to_mp_unit_caps_localised_name_mp_cap_unit_kho_mon_khornataurs_1	Minotaurs of Khorne (Great Weapons)	false
unit_set_to_mp_unit_caps_localised_name_mp_cap_unit_kho_mon_slaughterbrute	Slaughterbrute	false
unit_set_to_mp_unit_caps_localised_name_mp_cap_unit_kho_mon_soul_grinder_0	Soul Grinder (Khorne)	false
unit_set_to_mp_unit_caps_localised_name_mp_cap_unit_kho_veh_blood_shrine_0	Blood Shrine of Khorne	false
unit_set_to_mp_unit_caps_localised_name_mp_cap_unit_kho_veh_skullcannon_0	Skullcannon	false
unit_set_to_mp_unit_caps_localised_name_mp_cap_unit_ksl_cav_gryphon_legion_0	Gryphon Legion	false
unit_set_to_mp_unit_caps_localised_name_mp_cap_unit_ksl_cav_horse_archers_0	Horse Archers	false
unit_set_to_mp_unit_caps_localised_name_mp_cap_unit_ksl_cav_horse_raiders_0	Kossovite Dervishes	false
unit_set_to_mp_unit_caps_localised_name_mp_cap_unit_ksl_cav_war_bear_riders_1	War Bear Riders	false
unit_set_to_mp_unit_caps_localised_name_mp_cap_unit_ksl_cav_war_bear_riders_ror_0	Oath-Brothers of Tor	false
unit_set_to_mp_unit_caps_localised_name_mp_cap_unit_ksl_cav_winged_lancers_0	Winged Lancers	false
unit_set_to_mp_unit_caps_localised_name_mp_cap_unit_ksl_inf_akshina_ambushers	Akshina Ambushers	false
unit_set_to_mp_unit_caps_localised_name_mp_cap_unit_ksl_inf_akshina_ambushers_ror	The Wolfhearts	false
unit_set_to_mp_unit_caps_localised_name_mp_cap_unit_ksl_inf_armoured_kossars_0	Armoured Kossars	false
unit_set_to_mp_unit_caps_localised_name_mp_cap_unit_ksl_inf_armoured_kossars_1	Armoured Kossars (Great Weapons)	false
unit_set_to_mp_unit_caps_localised_name_mp_cap_unit_ksl_inf_armoured_kossars_ror	The Watchmen in the Night	false
unit_set_to_mp_unit_caps_localised_name_mp_cap_unit_ksl_inf_ice_guard_0	Ice Guard (Glaives)	false
unit_set_to_mp_unit_caps_localised_name_mp_cap_unit_ksl_inf_ice_guard_1	Ice Guard (Swords)	false
unit_set_to_mp_unit_caps_localised_name_mp_cap_unit_ksl_inf_kislevite_warriors	{{tr:land_units_onscreen_name_wh3_dlc24_ksl_inf_kislevite_warriors}}	false
unit_set_to_mp_unit_caps_localised_name_mp_cap_unit_ksl_inf_kossars_0	Kossars	false
unit_set_to_mp_unit_caps_localised_name_mp_cap_unit_ksl_inf_kossars_1	Kossars (Spears)	false
unit_set_to_mp_unit_caps_localised_name_mp_cap_unit_ksl_inf_streltsi_0	Streltsi	false
unit_set_to_mp_unit_caps_localised_name_mp_cap_unit_ksl_inf_streltsi_ror	Boydinov's Brawlers	false
unit_set_to_mp_unit_caps_localised_name_mp_cap_unit_ksl_inf_tzar_guard_0	Tzar Guard	false
unit_set_to_mp_unit_caps_localised_name_mp_cap_unit_ksl_inf_tzar_guard_1	Tzar Guard (Great Weapons)	false
unit_set_to_mp_unit_caps_localised_name_mp_cap_unit_ksl_inf_tzar_guard_ror_0	Dazh's Hearth-Blades 	false
unit_set_to_mp_unit_caps_localised_name_mp_cap_unit_ksl_mon_elemental_bear_0	Elemental Bear	false
unit_set_to_mp_unit_caps_localised_name_mp_cap_unit_ksl_mon_elemental_bear_0_ror	The Frozen Heart of Winter (Elemental Bear)	false
unit_set_to_mp_unit_caps_localised_name_mp_cap_unit_ksl_mon_frost_wyrm	{{tr:land_units_onscreen_name_wh3_dlc24_ksl_mon_frost_wyrm}}	false
unit_set_to_mp_unit_caps_localised_name_mp_cap_unit_ksl_mon_incarnate_elemental_of_beasts	Incarnate Elemental of Beasts	false
unit_set_to_mp_unit_caps_localised_name_mp_cap_unit_ksl_mon_snow_leopard_0	Snow Leopard	false
unit_set_to_mp_unit_caps_localised_name_mp_cap_unit_ksl_mon_things_in_the_woods	Things in the Woods	false
unit_set_to_mp_unit_caps_localised_name_mp_cap_unit_ksl_mon_things_in_the_woods_ror	The Mordheim Balewolves	false
unit_set_to_mp_unit_caps_localised_name_mp_cap_unit_ksl_veh_heavy_war_sled_0	Heavy War Sleds	false
unit_set_to_mp_unit_caps_localised_name_mp_cap_unit_ksl_veh_light_war_sled_0	Light War Sleds	false
unit_set_to_mp_unit_caps_localised_name_mp_cap_unit_ksl_veh_little_grom_0	Little Grom	false
unit_set_to_mp_unit_caps_localised_name_mp_cap_unit_lzd_cav_cold_one_riders	Cold One Riders	false
unit_set_to_mp_unit_caps_localised_name_mp_cap_unit_lzd_cav_cold_one_spear_riders	Cold One Spear-Riders	false
unit_set_to_mp_unit_caps_localised_name_mp_cap_unit_lzd_cav_cold_one_spearriders_ror_0	Pok-Hopak Cohort	false
unit_set_to_mp_unit_caps_localised_name_mp_cap_unit_lzd_cav_feral_cold_ones	Feral Cold Ones	false
unit_set_to_mp_unit_caps_localised_name_mp_cap_unit_lzd_cav_horned_ones	Horned Ones	false
unit_set_to_mp_unit_caps_localised_name_mp_cap_unit_lzd_cav_ripperdactyl_riders	Ripperdactyl Riders	false
unit_set_to_mp_unit_caps_localised_name_mp_cap_unit_lzd_cav_ripperdactyl_riders_ror_0	Colossadon Hunters	false
unit_set_to_mp_unit_caps_localised_name_mp_cap_unit_lzd_cav_terradon_riders_0	Terradon Riders	false
unit_set_to_mp_unit_caps_localised_name_mp_cap_unit_lzd_cav_terradon_riders_1	Terradon Riders (Fireleech Bolas)	false
unit_set_to_mp_unit_caps_localised_name_mp_cap_unit_lzd_cav_terradon_riders_ror_0	Pahaux Sentinels	false
unit_set_to_mp_unit_caps_localised_name_mp_cap_unit_lzd_inf_chameleon_skinks	Chameleon Skinks	false
unit_set_to_mp_unit_caps_localised_name_mp_cap_unit_lzd_inf_chameleon_stalkers	Chameleon Stalkers	false
unit_set_to_mp_unit_caps_localised_name_mp_cap_unit_lzd_inf_red_crested_skinks	Red Crested Skinks	false
unit_set_to_mp_unit_caps_localised_name_mp_cap_unit_lzd_inf_saurus_spears_0	Saurus Spears	false
unit_set_to_mp_unit_caps_localised_name_mp_cap_unit_lzd_inf_saurus_spears_1	Saurus Spears (Shields)	false
unit_set_to_mp_unit_caps_localised_name_mp_cap_unit_lzd_inf_saurus_warriors_0	Saurus Warriors	false
unit_set_to_mp_unit_caps_localised_name_mp_cap_unit_lzd_inf_saurus_warriors_1	Saurus Warriors (Shields)	false
unit_set_to_mp_unit_caps_localised_name_mp_cap_unit_lzd_inf_saurus_warriors_ror_0	Legion of Chaqua	false
unit_set_to_mp_unit_caps_localised_name_mp_cap_unit_lzd_inf_skink_cohort_0	Skink Cohort	false
unit_set_to_mp_unit_caps_localised_name_mp_cap_unit_lzd_inf_skink_cohort_1	Skink Cohort (Javelins)	false
unit_set_to_mp_unit_caps_localised_name_mp_cap_unit_lzd_inf_skink_red_crested_ror_0	Cohort of Sotek	false
unit_set_to_mp_unit_caps_localised_name_mp_cap_unit_lzd_inf_skink_skirmishers	Skink Skirmishers	false
unit_set_to_mp_unit_caps_localised_name_mp_cap_unit_lzd_inf_temple_guard	Temple Guard	false
unit_set_to_mp_unit_caps_localised_name_mp_cap_unit_lzd_inf_temple_guards_ror_0	Star Chamber Guardians	false
unit_set_to_mp_unit_caps_localised_name_mp_cap_unit_lzd_mon_ancient_salamander	Ancient Salamander	false
unit_set_to_mp_unit_caps_localised_name_mp_cap_unit_lzd_mon_ancient_stegadon_ror_0	The Thunderous One	false
unit_set_to_mp_unit_caps_localised_name_mp_cap_unit_lzd_mon_bastiladon	Bastiladon	false
unit_set_to_mp_unit_caps_localised_name_mp_cap_unit_lzd_mon_carnosaur	Carnosaur	false
unit_set_to_mp_unit_caps_localised_name_mp_cap_unit_lzd_mon_carnosaur_ror	Geltblöm's Terror	false
unit_set_to_mp_unit_caps_localised_name_mp_cap_unit_lzd_mon_coatl	Coatl	false
unit_set_to_mp_unit_caps_localised_name_mp_cap_unit_lzd_mon_coatl_ror	Spirit of Tepok	false
unit_set_to_mp_unit_caps_localised_name_mp_cap_unit_lzd_mon_dread_saurian	Dread Saurian	false
unit_set_to_mp_unit_caps_localised_name_mp_cap_unit_lzd_mon_dread_saurian_ror_0	The Shredder of Lustria	false
unit_set_to_mp_unit_caps_localised_name_mp_cap_unit_lzd_mon_kroxigors	Kroxigors	false
unit_set_to_mp_unit_caps_localised_name_mp_cap_unit_lzd_mon_razordon_hunting_pack	Razordon Hunting Pack	false
unit_set_to_mp_unit_caps_localised_name_mp_cap_unit_lzd_mon_razordon_pack_ror_0	Amaxon Barbs	false
unit_set_to_mp_unit_caps_localised_name_mp_cap_unit_lzd_mon_sacred_kroxigors	Sacred Kroxigors	false
unit_set_to_mp_unit_caps_localised_name_mp_cap_unit_lzd_mon_sacred_kroxigors_ror_0	Cohort of Huatl	false
unit_set_to_mp_unit_caps_localised_name_mp_cap_unit_lzd_mon_salamander_hunting_pack	Salamander Hunting Pack	false
unit_set_to_mp_unit_caps_localised_name_mp_cap_unit_lzd_mon_salamander_pack_ror_0	The Umbral Tide	false
unit_set_to_mp_unit_caps_localised_name_mp_cap_unit_lzd_mon_stegadon	Stegadon	false
unit_set_to_mp_unit_caps_localised_name_mp_cap_unit_lzd_mon_troglodon	Troglodon	false
unit_set_to_mp_unit_caps_localised_name_mp_cap_unit_lzd_mon_troglodon_ror	The Pale Death	false
unit_set_to_mp_unit_caps_localised_name_mp_cap_unit_mon_blood_vultures	{{tr:land_units_onscreen_name_wh3_dlc26_ogr_mon_blood_vultures}}	false
unit_set_to_mp_unit_caps_localised_name_mp_cap_unit_mon_celestial_lion	Celestial Lion	false
unit_set_to_mp_unit_caps_localised_name_mp_cap_unit_mon_great_moon_bird	Great Moon Birds	false
unit_set_to_mp_unit_caps_localised_name_mp_cap_unit_nor_cav_marauder_horsemasters	Marauder Horsemasters	false
unit_set_to_mp_unit_caps_localised_name_mp_cap_unit_nor_cav_marauder_horsemen_0	Marauder Horsemen	false
unit_set_to_mp_unit_caps_localised_name_mp_cap_unit_nor_cav_marauder_horsemen_1	Marauder Horsemen (Throwing Axes)	false
unit_set_to_mp_unit_caps_localised_name_mp_cap_unit_nor_inf_chaos_marauders_ror_0	Icehorn Marauders	false
unit_set_to_mp_unit_caps_localised_name_mp_cap_unit_nor_inf_ice_wolves	Norscan Ice Wolves	false
unit_set_to_mp_unit_caps_localised_name_mp_cap_unit_nor_inf_marauder_berserkers	Marauder Berserkers	false
unit_set_to_mp_unit_caps_localised_name_mp_cap_unit_nor_inf_marauder_berserkers_ror_0	Brutes of the Hound	false
unit_set_to_mp_unit_caps_localised_name_mp_cap_unit_nor_inf_marauder_champions_0	Marauder Champions	false
unit_set_to_mp_unit_caps_localised_name_mp_cap_unit_nor_inf_marauder_champions_1	Marauder Champions (Great Weapons)	false
unit_set_to_mp_unit_caps_localised_name_mp_cap_unit_nor_inf_marauder_hunters_0	Marauder Hunters	false
unit_set_to_mp_unit_caps_localised_name_mp_cap_unit_nor_inf_marauder_hunters_1	Marauder Hunters (Javelins)	false
unit_set_to_mp_unit_caps_localised_name_mp_cap_unit_nor_inf_marauder_spearmen	Marauder Spearmen	false
unit_set_to_mp_unit_caps_localised_name_mp_cap_unit_nor_inf_marauders_0	Marauders	false
unit_set_to_mp_unit_caps_localised_name_mp_cap_unit_nor_inf_marauders_1	Marauders (Great Weapons)	false
unit_set_to_mp_unit_caps_localised_name_mp_cap_unit_nor_inf_norscan_warhounds	Norscan Warhounds	false
unit_set_to_mp_unit_caps_localised_name_mp_cap_unit_nor_mon_armoured_skin_wolves	Skin Wolves (Armoured)	false
unit_set_to_mp_unit_caps_localised_name_mp_cap_unit_nor_mon_fimir_ror_0	Mist Stalkers	false
unit_set_to_mp_unit_caps_localised_name_mp_cap_unit_nor_mon_fimir_warriors_0	Fimir Warriors	false
unit_set_to_mp_unit_caps_localised_name_mp_cap_unit_nor_mon_fimir_warriors_1	Fimir Warriors (Great Weapons)	false
unit_set_to_mp_unit_caps_localised_name_mp_cap_unit_nor_mon_frost_wyrm	Chaos Frost Dragon	false
unit_set_to_mp_unit_caps_localised_name_mp_cap_unit_nor_mon_frost_wyrm_ror_0	The Cold-Voider	false
unit_set_to_mp_unit_caps_localised_name_mp_cap_unit_nor_mon_giant	Norscan Giant	false
unit_set_to_mp_unit_caps_localised_name_mp_cap_unit_nor_mon_ice_trolls	Ice Trolls	false
unit_set_to_mp_unit_caps_localised_name_mp_cap_unit_nor_mon_mammoths	Mammoths	false
unit_set_to_mp_unit_caps_localised_name_mp_cap_unit_nor_mon_manticore	Feral Manticore	false
unit_set_to_mp_unit_caps_localised_name_mp_cap_unit_nor_mon_marauder_warwolves_ror_0	Beasts of Tashnar	false
unit_set_to_mp_unit_caps_localised_name_mp_cap_unit_nor_mon_skin_wolves	Skin Wolves	false
unit_set_to_mp_unit_caps_localised_name_mp_cap_unit_nor_mon_skin_wolves_ror_0	Maws of Savagery	false
unit_set_to_mp_unit_caps_localised_name_mp_cap_unit_nor_mon_trolls	Trolls	false
unit_set_to_mp_unit_caps_localised_name_mp_cap_unit_nor_mon_war_mammoth_ror_0	Soulcrusher	false
unit_set_to_mp_unit_caps_localised_name_mp_cap_unit_nor_mon_war_mammoth_ror_1	Soulcrusher	false
unit_set_to_mp_unit_caps_localised_name_mp_cap_unit_nor_veh_ice_wolves_chariot	Ice Wolves Chariots	false
unit_set_to_mp_unit_caps_localised_name_mp_cap_unit_nor_veh_marauder_chariot	Marauder Chariots	false
unit_set_to_mp_unit_caps_localised_name_mp_cap_unit_nur_cav_plague_drones_0	Plague Drones of Nurgle	false
unit_set_to_mp_unit_caps_localised_name_mp_cap_unit_nur_cav_plague_drones_1	Plague Drones of Nurgle (Death's Heads)	false
unit_set_to_mp_unit_caps_localised_name_mp_cap_unit_nur_cav_plague_drones_ror	The Angels of Decay	false
unit_set_to_mp_unit_caps_localised_name_mp_cap_unit_nur_cav_pox_riders_of_nurgle_0	Pox Riders of Nurgle	false
unit_set_to_mp_unit_caps_localised_name_mp_cap_unit_nur_cav_pox_riders_of_nurgle_ror_0	Barons of the Bog	false
unit_set_to_mp_unit_caps_localised_name_mp_cap_unit_nur_cav_rot_knights	Rot Knights	false
unit_set_to_mp_unit_caps_localised_name_mp_cap_unit_nur_cav_rot_knights_ror	The Rotting Riders	false
unit_set_to_mp_unit_caps_localised_name_mp_cap_unit_nur_inf_chaos_furies_0	Chaos Furies (Nurgle)	false
unit_set_to_mp_unit_caps_localised_name_mp_cap_unit_nur_inf_nurglings_0	Nurglings	false
unit_set_to_mp_unit_caps_localised_name_mp_cap_unit_nur_inf_nurglings_ror	The Frolickers Bubonic	false
unit_set_to_mp_unit_caps_localised_name_mp_cap_unit_nur_inf_pestigors	Pestigors	false
unit_set_to_mp_unit_caps_localised_name_mp_cap_unit_nur_inf_plague_ogres	Plague Ogres	false
unit_set_to_mp_unit_caps_localised_name_mp_cap_unit_nur_inf_plague_ogres_great_weapons	Plague Ogres (Great Weapons)	false
unit_set_to_mp_unit_caps_localised_name_mp_cap_unit_nur_inf_plaguebearers_0	Plaguebearers of Nurgle	false
unit_set_to_mp_unit_caps_localised_name_mp_cap_unit_nur_inf_plaguebearers_1	Exalted Plaguebearers of Nurgle	false
unit_set_to_mp_unit_caps_localised_name_mp_cap_unit_nur_inf_plaguebearers_ror_0	Festering Stooges	false
unit_set_to_mp_unit_caps_localised_name_mp_cap_unit_nur_mon_beast_of_nurgle_0	Beast of Nurgle	false
unit_set_to_mp_unit_caps_localised_name_mp_cap_unit_nur_mon_bile_trolls	Bile Trolls	false
unit_set_to_mp_unit_caps_localised_name_mp_cap_unit_nur_mon_great_unclean_one_0	Great Unclean One	false
unit_set_to_mp_unit_caps_localised_name_mp_cap_unit_nur_mon_great_unclean_one_0_ror	Uncle Furuncle (Great Unclean One)	false
unit_set_to_mp_unit_caps_localised_name_mp_cap_unit_nur_mon_plague_toads_0	Plague Toads of Nurgle	false
unit_set_to_mp_unit_caps_localised_name_mp_cap_unit_nur_mon_rot_flies_0	Rot Flies	false
unit_set_to_mp_unit_caps_localised_name_mp_cap_unit_nur_mon_soul_grinder_0	Soul Grinder (Nurgle)	false
unit_set_to_mp_unit_caps_localised_name_mp_cap_unit_nur_mon_soul_grinder_0_ror	Noxbringer	false
unit_set_to_mp_unit_caps_localised_name_mp_cap_unit_nur_mon_toad_dragon	Toad Dragon	false
unit_set_to_mp_unit_caps_localised_name_mp_cap_unit_ogr_cav_crushers_0	Crushers (Ironfists)	false
unit_set_to_mp_unit_caps_localised_name_mp_cap_unit_ogr_cav_crushers_1	Crushers (Great Weapons)	false
unit_set_to_mp_unit_caps_localised_name_mp_cap_unit_ogr_cav_crushers_ror_0	Sky-Striders	false
unit_set_to_mp_unit_caps_localised_name_mp_cap_unit_ogr_cav_mournfang_cavalry_0	Mournfang Cavalry	false
unit_set_to_mp_unit_caps_localised_name_mp_cap_unit_ogr_cav_mournfang_cavalry_1	Mournfang Cavalry (Ironfists)	false
unit_set_to_mp_unit_caps_localised_name_mp_cap_unit_ogr_cav_mournfang_cavalry_2	Mournfang Cavalry (Great Weapons)	false
unit_set_to_mp_unit_caps_localised_name_mp_cap_unit_ogr_inf_eshin_maneater_ror	{{tr:land_units_onscreen_name_wh3_dlc26_ogr_inf_eshin_maneater_ror}}	false
unit_set_to_mp_unit_caps_localised_name_mp_cap_unit_ogr_inf_gnoblars_0	Gnoblars	false
unit_set_to_mp_unit_caps_localised_name_mp_cap_unit_ogr_inf_gnoblars_1	Gnoblar Trappers	false
unit_set_to_mp_unit_caps_localised_name_mp_cap_unit_ogr_inf_gnoblars_flingers	Gnoblar Flingers	false
unit_set_to_mp_unit_caps_localised_name_mp_cap_unit_ogr_inf_gnoblars_ror	Boglars of the Mad Marshes	false
unit_set_to_mp_unit_caps_localised_name_mp_cap_unit_ogr_inf_golgfags_maneaters	Golgfag's Maneaters	false
unit_set_to_mp_unit_caps_localised_name_mp_cap_unit_ogr_inf_ironguts_0	Ironguts	false
unit_set_to_mp_unit_caps_localised_name_mp_cap_unit_ogr_inf_leadbelchers_0	Leadbelchers	false
unit_set_to_mp_unit_caps_localised_name_mp_cap_unit_ogr_inf_maneaters_0	Maneaters	false
unit_set_to_mp_unit_caps_localised_name_mp_cap_unit_ogr_inf_maneaters_1	Maneaters (Ironfists)	false
unit_set_to_mp_unit_caps_localised_name_mp_cap_unit_ogr_inf_maneaters_2	Maneaters (Great Weapons)	false
unit_set_to_mp_unit_caps_localised_name_mp_cap_unit_ogr_inf_maneaters_3	Maneaters (Ogre Pistol)	false
unit_set_to_mp_unit_caps_localised_name_mp_cap_unit_ogr_inf_maneaters_ror_0	Powder-Guts	false
unit_set_to_mp_unit_caps_localised_name_mp_cap_unit_ogr_inf_ogres_0	Ogre Bulls	false
unit_set_to_mp_unit_caps_localised_name_mp_cap_unit_ogr_inf_ogres_1	Ogre Bulls (Dual Weapons)	false
unit_set_to_mp_unit_caps_localised_name_mp_cap_unit_ogr_inf_ogres_2	Ogre Bulls (Ironfists)	false
unit_set_to_mp_unit_caps_localised_name_mp_cap_unit_ogr_inf_pigback_riders	Pigback Riders	false
unit_set_to_mp_unit_caps_localised_name_mp_cap_unit_ogr_inf_pigback_riders_ror	{{tr:land_units_onscreen_name_wh3_dlc26_ogr_inf_pigback_riders_ror}}	false
unit_set_to_mp_unit_caps_localised_name_mp_cap_unit_ogr_mon_giant_0	Giant	false
unit_set_to_mp_unit_caps_localised_name_mp_cap_unit_ogr_mon_gorgers_0	Gorgers	false
unit_set_to_mp_unit_caps_localised_name_mp_cap_unit_ogr_mon_sabretusk_pack_0	Sabretusk Pack	false
unit_set_to_mp_unit_caps_localised_name_mp_cap_unit_ogr_mon_stonehorn_0	Stonehorn	false
unit_set_to_mp_unit_caps_localised_name_mp_cap_unit_ogr_mon_stonehorn_0_ror	The Snowhorn of Mourn (Stonehorn)	false
unit_set_to_mp_unit_caps_localised_name_mp_cap_unit_ogr_mon_stonehorn_1	Stonehorn (Harpoon Launcher)	false
unit_set_to_mp_unit_caps_localised_name_mp_cap_unit_ogr_mon_thundertusk	{{tr:land_units_onscreen_name_wh3_dlc26_ogr_mon_thundertusk}}	false
unit_set_to_mp_unit_caps_localised_name_mp_cap_unit_ogr_mon_yhetees	Yhetees	false
unit_set_to_mp_unit_caps_localised_name_mp_cap_unit_ogr_mon_yhetees_ror	{{tr:land_units_onscreen_name_wh3_dlc26_ogr_mon_yhetees_ror}}	false
unit_set_to_mp_unit_caps_localised_name_mp_cap_unit_ogr_veh_gnoblar_scraplauncher_0	Gnoblar Scraplauncher	false
unit_set_to_mp_unit_caps_localised_name_mp_cap_unit_ogr_veh_ironblaster_0	Ironblaster	false
unit_set_to_mp_unit_caps_localised_name_mp_cap_unit_skv_art_warp_lightning_cannon_ror_0	Ikit's Zzzzap-Zzzzap!	false
unit_set_to_mp_unit_caps_localised_name_mp_cap_unit_skv_inf_clanrat_spearmen_0	Clanrat Spears	false
unit_set_to_mp_unit_caps_localised_name_mp_cap_unit_skv_inf_clanrat_spearmen_1	Clanrat Spears (Shields)	false
unit_set_to_mp_unit_caps_localised_name_mp_cap_unit_skv_inf_clanrats_0	Clanrats	false
unit_set_to_mp_unit_caps_localised_name_mp_cap_unit_skv_inf_clanrats_1	Clanrats (Shields)	false
unit_set_to_mp_unit_caps_localised_name_mp_cap_unit_skv_inf_clanrats_ror_0	Clan Vulkn Tailslashers	false
unit_set_to_mp_unit_caps_localised_name_mp_cap_unit_skv_inf_death_globe_bombardiers	Death Globe Bombardiers	false
unit_set_to_mp_unit_caps_localised_name_mp_cap_unit_skv_inf_death_runners	Death Runners	false
unit_set_to_mp_unit_caps_localised_name_mp_cap_unit_skv_inf_death_runners_ror	Visktrin's Death Squad	false
unit_set_to_mp_unit_caps_localised_name_mp_cap_unit_skv_inf_eshin_triads	Eshin Triads	false
unit_set_to_mp_unit_caps_localised_name_mp_cap_unit_skv_inf_eshin_triads_ror	Iksha's Triads	false
unit_set_to_mp_unit_caps_localised_name_mp_cap_unit_skv_inf_gutter_runner_slingers_0	Gutter Runner Slingers	false
unit_set_to_mp_unit_caps_localised_name_mp_cap_unit_skv_inf_gutter_runner_slingers_1	Gutter Runner Slingers (Poison)	false
unit_set_to_mp_unit_caps_localised_name_mp_cap_unit_skv_inf_gutter_runners_0	Gutter Runners	false
unit_set_to_mp_unit_caps_localised_name_mp_cap_unit_skv_inf_gutter_runners_1	Gutter Runners (Poison)	false
unit_set_to_mp_unit_caps_localised_name_mp_cap_unit_skv_inf_night_runner_slingers_0	Night Runners (Slings)	false
unit_set_to_mp_unit_caps_localised_name_mp_cap_unit_skv_inf_night_runners	Night Runners	false
unit_set_to_mp_unit_caps_localised_name_mp_cap_unit_skv_inf_plague_monk_censer_bearer_ror_0	Blightscab's Plaguepack	false
unit_set_to_mp_unit_caps_localised_name_mp_cap_unit_skv_inf_plague_monk_censer_bearers	Plaguemonk Censer Bearers	false
unit_set_to_mp_unit_caps_localised_name_mp_cap_unit_skv_inf_plague_monks	Plague Monks	false
unit_set_to_mp_unit_caps_localised_name_mp_cap_unit_skv_inf_poison_wind_globadiers	Poison Wind Globadiers	false
unit_set_to_mp_unit_caps_localised_name_mp_cap_unit_skv_inf_poison_wind_mortar	Poisoned Wind Mortars	false
unit_set_to_mp_unit_caps_localised_name_mp_cap_unit_skv_inf_poison_wind_mortar_ror	The Avalanche Mortars	false
unit_set_to_mp_unit_caps_localised_name_mp_cap_unit_skv_inf_ratling_gun_ror_0	Teeth-Breakers 	false
unit_set_to_mp_unit_caps_localised_name_mp_cap_unit_skv_inf_ratling_guns	Ratling Guns	false
unit_set_to_mp_unit_caps_localised_name_mp_cap_unit_skv_inf_skavenslave_slingers	Skavenslave Slingers	false
unit_set_to_mp_unit_caps_localised_name_mp_cap_unit_skv_inf_skavenslave_spears	Skavenslave Spears	false
unit_set_to_mp_unit_caps_localised_name_mp_cap_unit_skv_inf_skavenslaves	Skavenslaves	false
unit_set_to_mp_unit_caps_localised_name_mp_cap_unit_skv_inf_stormvermin_0	Stormvermin (Halberds)	false
unit_set_to_mp_unit_caps_localised_name_mp_cap_unit_skv_inf_stormvermin_1	Stormvermin (Sword & Shield)	false
unit_set_to_mp_unit_caps_localised_name_mp_cap_unit_skv_inf_stormvermin_ror_0	Council Guard	false
unit_set_to_mp_unit_caps_localised_name_mp_cap_unit_skv_inf_warp_grinder	Warp-Grinders	false
unit_set_to_mp_unit_caps_localised_name_mp_cap_unit_skv_inf_warpfire_throwers	Warpfire Throwers	false
unit_set_to_mp_unit_caps_localised_name_mp_cap_unit_skv_inf_warplock_jezzails	Warplock Jezzails	false
unit_set_to_mp_unit_caps_localised_name_mp_cap_unit_skv_inf_warplock_jezzails_ror_0	Natty Buboe's Sharpshooters	false
unit_set_to_mp_unit_caps_localised_name_mp_cap_unit_skv_mon_art_plagueclaw_catapult	Plagueclaw Catapult	false
unit_set_to_mp_unit_caps_localised_name_mp_cap_unit_skv_mon_art_warp_lightning_cannon	Warp Lightning Cannon	false
unit_set_to_mp_unit_caps_localised_name_mp_cap_unit_skv_mon_brood_horror_0	Brood Horror	false
unit_set_to_mp_unit_caps_localised_name_mp_cap_unit_skv_mon_hell_pit_abomination	Hell Pit Abomination	false
unit_set_to_mp_unit_caps_localised_name_mp_cap_unit_skv_mon_hell_pit_abomination_ror_0	The Thing-Thing	false
unit_set_to_mp_unit_caps_localised_name_mp_cap_unit_skv_mon_rat_ogre_mutant	Mutant Rat Ogre	false
unit_set_to_mp_unit_caps_localised_name_mp_cap_unit_skv_mon_rat_ogre_mutant_ror_0	Morskittar's Hellion	false
unit_set_to_mp_unit_caps_localised_name_mp_cap_unit_skv_mon_rat_ogres	Rat Ogres	false
unit_set_to_mp_unit_caps_localised_name_mp_cap_unit_skv_mon_rat_ogres_ror_0	Pit Fighters of Hell's Deep	false
unit_set_to_mp_unit_caps_localised_name_mp_cap_unit_skv_mon_veh_doom_flayers	Doom Flayers	false
unit_set_to_mp_unit_caps_localised_name_mp_cap_unit_skv_mon_veh_doomwheel	Doomwheel	false
unit_set_to_mp_unit_caps_localised_name_mp_cap_unit_skv_mon_wolf_rats_0	Wolf Rats	false
unit_set_to_mp_unit_caps_localised_name_mp_cap_unit_skv_mon_wolf_rats_1	Wolf Rats (Poison)	false
unit_set_to_mp_unit_caps_localised_name_mp_cap_unit_skv_veh_doom_flayer_ror_0	Dwarf-Thing Menace	false
unit_set_to_mp_unit_caps_localised_name_mp_cap_unit_skv_veh_doomwheel_ror_0	Wheelz of Dooom	false
unit_set_to_mp_unit_caps_localised_name_mp_cap_unit_sla_cav_heartseekers_of_slaanesh_0	Heartseekers of Slaanesh	false
unit_set_to_mp_unit_caps_localised_name_mp_cap_unit_sla_cav_heartseekers_of_slaanesh_ror_0	Eternal Entourage	false
unit_set_to_mp_unit_caps_localised_name_mp_cap_unit_sla_cav_hellstriders_0	Hellstriders of Slaanesh	false
unit_set_to_mp_unit_caps_localised_name_mp_cap_unit_sla_cav_hellstriders_1	Hellstriders of Slaanesh (Hellscourges)	false
unit_set_to_mp_unit_caps_localised_name_mp_cap_unit_sla_cav_seekers_of_slaanesh_0	Seekers of Slaanesh	false
unit_set_to_mp_unit_caps_localised_name_mp_cap_unit_sla_inf_chaos_furies_0	Chaos Furies (Slaanesh)	false
unit_set_to_mp_unit_caps_localised_name_mp_cap_unit_sla_inf_daemonette_0	Daemonettes of Slaanesh	false
unit_set_to_mp_unit_caps_localised_name_mp_cap_unit_sla_inf_daemonette_1	Exalted Daemonettes of Slaanesh	false
unit_set_to_mp_unit_caps_localised_name_mp_cap_unit_sla_inf_daemonette_ror_0	Bringers of Beguilement	false
unit_set_to_mp_unit_caps_localised_name_mp_cap_unit_sla_inf_marauders_0	Devoted Marauders of Slaanesh	false
unit_set_to_mp_unit_caps_localised_name_mp_cap_unit_sla_inf_marauders_1	Devoted Marauders of Slaanesh (Spears)	false
unit_set_to_mp_unit_caps_localised_name_mp_cap_unit_sla_inf_marauders_2	Devoted Marauders of Slaanesh (Hellscourges)	false
unit_set_to_mp_unit_caps_localised_name_mp_cap_unit_sla_inf_marauders_spears_ror	The Princes of Perfection	false
unit_set_to_mp_unit_caps_localised_name_mp_cap_unit_sla_mon_fiends_of_slaanesh_0	Fiends of Slaanesh	false
unit_set_to_mp_unit_caps_localised_name_mp_cap_unit_sla_mon_keeper_of_secrets_0	Keeper of Secrets	false
unit_set_to_mp_unit_caps_localised_name_mp_cap_unit_sla_mon_keeper_of_secrets_0_ror	The Marquis of Masochism (Keeper of Secrets)	false
unit_set_to_mp_unit_caps_localised_name_mp_cap_unit_sla_mon_soul_grinder_0	Soul Grinder (Slaanesh)	false
unit_set_to_mp_unit_caps_localised_name_mp_cap_unit_sla_veh_exalted_seeker_chariot_0	Exalted Seeker Chariots	false
unit_set_to_mp_unit_caps_localised_name_mp_cap_unit_sla_veh_hellflayer_0	Hellflayers	false
unit_set_to_mp_unit_caps_localised_name_mp_cap_unit_sla_veh_seeker_chariot_0	Seeker Chariots	false
unit_set_to_mp_unit_caps_localised_name_mp_cap_unit_tmb_art_casket_of_souls	Casket of Souls	false
unit_set_to_mp_unit_caps_localised_name_mp_cap_unit_tmb_art_screaming_skull_catapult	Screaming Skull Catapult	false
unit_set_to_mp_unit_caps_localised_name_mp_cap_unit_tmb_cav_necropolis_knights_0	Necropolis Knights	false
unit_set_to_mp_unit_caps_localised_name_mp_cap_unit_tmb_cav_necropolis_knights_1	Necropolis Knights (Halberds)	false
unit_set_to_mp_unit_caps_localised_name_mp_cap_unit_tmb_cav_nehekhara_horsemen	Nehekhara Horsemen	false
unit_set_to_mp_unit_caps_localised_name_mp_cap_unit_tmb_cav_skeleton_horsemen	Skeleton Horsemen	false
unit_set_to_mp_unit_caps_localised_name_mp_cap_unit_tmb_cav_skeleton_horsemen_archers	Skeleton Horsemen Archers	false
unit_set_to_mp_unit_caps_localised_name_mp_cap_unit_tmb_inf_nehekhara_warriors	Nehekhara Warriors	false
unit_set_to_mp_unit_caps_localised_name_mp_cap_unit_tmb_inf_skeleton_archers	Skeleton Archers	false
unit_set_to_mp_unit_caps_localised_name_mp_cap_unit_tmb_inf_skeleton_archers_ror	Blessed Legion of Phakth	false
unit_set_to_mp_unit_caps_localised_name_mp_cap_unit_tmb_inf_skeleton_spearmen	Skeleton Spearmen	false
unit_set_to_mp_unit_caps_localised_name_mp_cap_unit_tmb_inf_skeleton_spearmen_ror	King Nekhesh's Scorpion Legion	false
unit_set_to_mp_unit_caps_localised_name_mp_cap_unit_tmb_inf_skeleton_warriors	Skeleton Warriors	false
unit_set_to_mp_unit_caps_localised_name_mp_cap_unit_tmb_inf_tomb_guard_0	Tomb Guard	false
unit_set_to_mp_unit_caps_localised_name_mp_cap_unit_tmb_inf_tomb_guard_1	Tomb Guard (Halberds)	false
unit_set_to_mp_unit_caps_localised_name_mp_cap_unit_tmb_inf_tomb_guard_ror	The Khepra Guard	false
unit_set_to_mp_unit_caps_localised_name_mp_cap_unit_tmb_mon_bone_giant	Bone Giant	false
unit_set_to_mp_unit_caps_localised_name_mp_cap_unit_tmb_mon_carrion	Carrion	false
unit_set_to_mp_unit_caps_localised_name_mp_cap_unit_tmb_mon_hierotitan	Hierotitan	false
unit_set_to_mp_unit_caps_localised_name_mp_cap_unit_tmb_mon_khemrian_warsphinx	Khemrian Warsphinx	false
unit_set_to_mp_unit_caps_localised_name_mp_cap_unit_tmb_mon_necrosphinx	Necrosphinx	false
unit_set_to_mp_unit_caps_localised_name_mp_cap_unit_tmb_mon_necrosphinx_ror	The Sphinx of Usekhp	false
unit_set_to_mp_unit_caps_localised_name_mp_cap_unit_tmb_mon_sepulchral_stalkers	Sepulchral Stalkers	false
unit_set_to_mp_unit_caps_localised_name_mp_cap_unit_tmb_mon_sepulchral_stalkers_ror	Eyes of the Desert	false
unit_set_to_mp_unit_caps_localised_name_mp_cap_unit_tmb_mon_tomb_scorpion	Tomb Scorpion	false
unit_set_to_mp_unit_caps_localised_name_mp_cap_unit_tmb_mon_ushabti_0	Ushabti	false
unit_set_to_mp_unit_caps_localised_name_mp_cap_unit_tmb_mon_ushabti_1	Ushabti (Great Bows)	false
unit_set_to_mp_unit_caps_localised_name_mp_cap_unit_tmb_mon_ushabti_ror	Chosen of the Gods	false
unit_set_to_mp_unit_caps_localised_name_mp_cap_unit_tmb_veh_skeleton_archer_chariots	Skeleton Archer Chariots	false
unit_set_to_mp_unit_caps_localised_name_mp_cap_unit_tmb_veh_skeleton_chariots	Skeleton Chariots	false
unit_set_to_mp_unit_caps_localised_name_mp_cap_unit_tze_cav_doom_knights_0	Doom Knights of Tzeentch	false
unit_set_to_mp_unit_caps_localised_name_mp_cap_unit_tze_cav_doom_knights_ror_0	Knights of Immolation	false
unit_set_to_mp_unit_caps_localised_name_mp_cap_unit_tze_inf_blue_horrors_0	Blue Horrors of Tzeentch	false
unit_set_to_mp_unit_caps_localised_name_mp_cap_unit_tze_inf_blue_horrors_ror	The Chromatic Abominations	false
unit_set_to_mp_unit_caps_localised_name_mp_cap_unit_tze_inf_centigors_great_weapons	{{tr:land_units_onscreen_name_wh3_dlc24_tze_inf_centigors_great_weapons}}	false
unit_set_to_mp_unit_caps_localised_name_mp_cap_unit_tze_inf_chaos_furies_0	Chaos Furies (Tzeentch)	false
unit_set_to_mp_unit_caps_localised_name_mp_cap_unit_tze_inf_pink_horrors_0	Pink Horrors of Tzeentch	false
unit_set_to_mp_unit_caps_localised_name_mp_cap_unit_tze_inf_pink_horrors_1	Exalted Pink Horrors of Tzeentch	false
unit_set_to_mp_unit_caps_localised_name_mp_cap_unit_tze_inf_pink_horrors_of_tzeentch_ror	The Sourguts	false
unit_set_to_mp_unit_caps_localised_name_mp_cap_unit_tze_inf_pink_horrors_ror_0	Blazing Squealers	false
unit_set_to_mp_unit_caps_localised_name_mp_cap_unit_tze_inf_tzaangors	Tzaangors	false
unit_set_to_mp_unit_caps_localised_name_mp_cap_unit_tze_mon_cockatrice	Cockatrice	false
unit_set_to_mp_unit_caps_localised_name_mp_cap_unit_tze_mon_exalted_flamers_0	Exalted Flamer of Tzeentch	false
unit_set_to_mp_unit_caps_localised_name_mp_cap_unit_tze_mon_flamers_0	Flamers of Tzeentch	false
unit_set_to_mp_unit_caps_localised_name_mp_cap_unit_tze_mon_flamers_changebringers	{{tr:land_units_onscreen_name_wh3_dlc24_tze_mon_flamers_changebringers}}	false
unit_set_to_mp_unit_caps_localised_name_mp_cap_unit_tze_mon_lord_of_change_0	Lord of Change	false
unit_set_to_mp_unit_caps_localised_name_mp_cap_unit_tze_mon_lord_of_change_0_ror	The Golden Griffin of Theurgy (Lord of Change)	false
unit_set_to_mp_unit_caps_localised_name_mp_cap_unit_tze_mon_mutalith_vortex_beast	Mutalith Vortex Beast	false
unit_set_to_mp_unit_caps_localised_name_mp_cap_unit_tze_mon_mutalith_vortex_beast_ror	Aeson the Fallen	false
unit_set_to_mp_unit_caps_localised_name_mp_cap_unit_tze_mon_screamers_0	Screamers of Tzeentch	false
unit_set_to_mp_unit_caps_localised_name_mp_cap_unit_tze_mon_screamers_ror	Shrieking Skyrays	false
unit_set_to_mp_unit_caps_localised_name_mp_cap_unit_tze_mon_soul_grinder_0	Soul Grinder (Tzeentch)	false
unit_set_to_mp_unit_caps_localised_name_mp_cap_unit_tze_veh_burning_chariot_0	Burning Chariot of Tzeentch	false
unit_set_to_mp_unit_caps_localised_name_mp_cap_unit_vmp_cav_black_knights_0	Black Knights	false
unit_set_to_mp_unit_caps_localised_name_mp_cap_unit_vmp_cav_black_knights_3	Black Knights (Lances & Barding)	false
unit_set_to_mp_unit_caps_localised_name_mp_cap_unit_vmp_cav_blood_knights	Blood Knights	false
unit_set_to_mp_unit_caps_localised_name_mp_cap_unit_vmp_cav_blood_knights_1	{{tr:land_units_onscreen_name_wh_dlc02_vmp_cav_blood_knights_0}}	false
unit_set_to_mp_unit_caps_localised_name_mp_cap_unit_vmp_cav_chillgheists_0	Chillgheists	false
unit_set_to_mp_unit_caps_localised_name_mp_cap_unit_vmp_cav_hexwraiths	Hexwraiths	false
unit_set_to_mp_unit_caps_localised_name_mp_cap_unit_vmp_cav_vereks_reavers_0	Verek's Reavers	false
unit_set_to_mp_unit_caps_localised_name_mp_cap_unit_vmp_inf_cairn_wraiths	Cairn Wraiths	false
unit_set_to_mp_unit_caps_localised_name_mp_cap_unit_vmp_inf_crypt_ghouls	Crypt Ghouls	false
unit_set_to_mp_unit_caps_localised_name_mp_cap_unit_vmp_inf_dire_wolves	Dire Wolves	false
unit_set_to_mp_unit_caps_localised_name_mp_cap_unit_vmp_inf_feasters_in_the_dusk_0	Feasters in the Dusk	false
unit_set_to_mp_unit_caps_localised_name_mp_cap_unit_vmp_inf_fell_bats	Fell Bats	false
unit_set_to_mp_unit_caps_localised_name_mp_cap_unit_vmp_inf_grave_guard_0	Grave Guard	false
unit_set_to_mp_unit_caps_localised_name_mp_cap_unit_vmp_inf_grave_guard_1	Grave Guard (Great Weapons)	false
unit_set_to_mp_unit_caps_localised_name_mp_cap_unit_vmp_inf_grave_guard_2	Grave Guard (Halberds)	false
unit_set_to_mp_unit_caps_localised_name_mp_cap_unit_vmp_inf_konigstein_stalkers_0	Konigstein Stalkers	false
unit_set_to_mp_unit_caps_localised_name_mp_cap_unit_vmp_inf_skeleton_spearmen	Skeleton Spearmen	false
unit_set_to_mp_unit_caps_localised_name_mp_cap_unit_vmp_inf_skeleton_warriors	Skeleton Warriors	false
unit_set_to_mp_unit_caps_localised_name_mp_cap_unit_vmp_inf_sternsmen_0	Sternsmen	false
unit_set_to_mp_unit_caps_localised_name_mp_cap_unit_vmp_inf_tithe_0	The Tithe	false
unit_set_to_mp_unit_caps_localised_name_mp_cap_unit_vmp_inf_zombies	Zombies	false
unit_set_to_mp_unit_caps_localised_name_mp_cap_unit_vmp_mon_crypt_horrors	Crypt Horrors	false
unit_set_to_mp_unit_caps_localised_name_mp_cap_unit_vmp_mon_devils_swartzhafen_0	Devils of Swartzhafen	false
unit_set_to_mp_unit_caps_localised_name_mp_cap_unit_vmp_mon_direpack_0	The Direpack	false
unit_set_to_mp_unit_caps_localised_name_mp_cap_unit_vmp_mon_terrorgheist	Terrorgheist	false
unit_set_to_mp_unit_caps_localised_name_mp_cap_unit_vmp_mon_vargheists	Vargheists	false
unit_set_to_mp_unit_caps_localised_name_mp_cap_unit_vmp_mon_varghulf	Varghulf	false
unit_set_to_mp_unit_caps_localised_name_mp_cap_unit_vmp_veh_black_coach	Black Coach	false
unit_set_to_mp_unit_caps_localised_name_mp_cap_unit_vmp_veh_claw_of_nagash_0	Claw of Nagash	false
unit_set_to_mp_unit_caps_localised_name_mp_cap_unit_vmp_veh_corpse_cart	Corpse Cart	false
unit_set_to_mp_unit_caps_localised_name_mp_cap_unit_vmp_veh_corpse_cart_balefire	Corpse Cart (Balefire)	false
unit_set_to_mp_unit_caps_localised_name_mp_cap_unit_vmp_veh_corpse_cart_lodestone	Corpse Cart (Unholy Lodestone)	false
unit_set_to_mp_unit_caps_localised_name_mp_cap_unit_vmp_veh_mortis_engine	Mortis Engine	false
unit_set_to_mp_unit_caps_localised_name_mp_cap_unit_wef_cav_glade_riders_0	Glade Riders	false
unit_set_to_mp_unit_caps_localised_name_mp_cap_unit_wef_cav_glade_riders_1	Glade Riders (Hagbane Tips)	false
unit_set_to_mp_unit_caps_localised_name_mp_cap_unit_wef_cav_glade_riders_2	Glade Riders (Spears)	false
unit_set_to_mp_unit_caps_localised_name_mp_cap_unit_wef_cav_great_stag_knights_0	Great Stag Knights	false
unit_set_to_mp_unit_caps_localised_name_mp_cap_unit_wef_cav_great_stag_knights_ror_0	Lost Sylvan Knights	false
unit_set_to_mp_unit_caps_localised_name_mp_cap_unit_wef_cav_hawk_riders	Hawk Riders	false
unit_set_to_mp_unit_caps_localised_name_mp_cap_unit_wef_cav_sisters_of_the_thorn	Sisters of the Thorn	false
unit_set_to_mp_unit_caps_localised_name_mp_cap_unit_wef_cav_wild_riders_0	Wild Riders	false
unit_set_to_mp_unit_caps_localised_name_mp_cap_unit_wef_cav_wild_riders_1	Wild Riders (Shields)	false
unit_set_to_mp_unit_caps_localised_name_mp_cap_unit_wef_cav_wild_riders_ror_0	Wild Hunters of Kurnous	false
unit_set_to_mp_unit_caps_localised_name_mp_cap_unit_wef_inf_bladesingers_0	Bladesingers	false
unit_set_to_mp_unit_caps_localised_name_mp_cap_unit_wef_inf_deepwood_scouts_0	Deepwood Scouts	false
unit_set_to_mp_unit_caps_localised_name_mp_cap_unit_wef_inf_deepwood_scouts_1	Deepwood Scouts (Swiftshiver Shards)	false
unit_set_to_mp_unit_caps_localised_name_mp_cap_unit_wef_inf_dryads	Dryads	false
unit_set_to_mp_unit_caps_localised_name_mp_cap_unit_wef_inf_dryads_ror_0	Wraiths of the Frozen Heart	false
unit_set_to_mp_unit_caps_localised_name_mp_cap_unit_wef_inf_eternal_guard_0	Eternal Guard	false
unit_set_to_mp_unit_caps_localised_name_mp_cap_unit_wef_inf_eternal_guard_1	Eternal Guard (Shields)	false
unit_set_to_mp_unit_caps_localised_name_mp_cap_unit_wef_inf_eternal_guard_ror_0	Winterheart Guards	false
unit_set_to_mp_unit_caps_localised_name_mp_cap_unit_wef_inf_glade_guard_0	Glade Guard	false
unit_set_to_mp_unit_caps_localised_name_mp_cap_unit_wef_inf_glade_guard_1	Glade Guard (Starfire Shafts)	false
unit_set_to_mp_unit_caps_localised_name_mp_cap_unit_wef_inf_glade_guard_2	Glade Guard (Hagbane Tips)	false
unit_set_to_mp_unit_caps_localised_name_mp_cap_unit_wef_inf_wardancers_0	Wardancers	false
unit_set_to_mp_unit_caps_localised_name_mp_cap_unit_wef_inf_wardancers_1	Wardancers (Asrai Spears)	false
unit_set_to_mp_unit_caps_localised_name_mp_cap_unit_wef_inf_wardancers_ror_0	Loec's Tricksters	false
unit_set_to_mp_unit_caps_localised_name_mp_cap_unit_wef_inf_waywatchers	Waywatchers	false
unit_set_to_mp_unit_caps_localised_name_mp_cap_unit_wef_inf_waywatchers_ror_0	Hawk-Eyes of Drakira	false
unit_set_to_mp_unit_caps_localised_name_mp_cap_unit_wef_inf_wildwood_rangers	Wildwood Rangers	false
unit_set_to_mp_unit_caps_localised_name_mp_cap_unit_wef_inf_wildwood_rangers_ror_0	Wardens of Cythral	false
unit_set_to_mp_unit_caps_localised_name_mp_cap_unit_wef_mon_eagle	Great Eagle	false
unit_set_to_mp_unit_caps_localised_name_mp_cap_unit_wef_mon_forest_dragon	Forest Dragon	false
unit_set_to_mp_unit_caps_localised_name_mp_cap_unit_wef_mon_griffon	Griffon	false
unit_set_to_mp_unit_caps_localised_name_mp_cap_unit_wef_mon_treekin	Treekin	false
unit_set_to_mp_unit_caps_localised_name_mp_cap_unit_wef_mon_treekin_ror_0	Firebark Elders	false
unit_set_to_mp_unit_caps_localised_name_mp_cap_unit_wef_mon_treemen	Treemen	false
unit_set_to_mp_unit_caps_localised_name_mp_cap_unit_wef_mon_zoats	Zoats	false
unit_set_to_mp_unit_caps_localised_name_mp_cap_unit_wef_mon_zoats_ror_0	Enigmas of Ghyran	false
unit_set_to_mp_unit_caps_localised_name_mp_cap_units_kho_inf_skullreapers	Skullreapers	false
