effect	bonus_value_id
#effect_bonus_value_basic_junction_tables;0;db/effect_bonus_value_basic_junction_tables/data__	
wh2_dlc09_effect_economy_gdp_mod_culture_tmb	gdp_mod_entertainment
wh2_dlc09_effect_force_own_campaign_movement_range_province	mod_land_movement_campaign
wh2_dlc09_effect_increase_army_capacity_hidden	army_cap_bonus
wh2_dlc09_effect_increase_army_capacity	army_cap_bonus
wh2_dlc09_effect_tower_projectile_tmb_2	autoresolver_tower_level
wh2_dlc11_cst_ship_growth_character	military_force_development_growth_characters
wh2_dlc11_cst_ship_growth	military_force_development_growth_core
wh2_dlc11_effect_blackark_growth_char	military_force_development_growth_characters
wh2_dlc11_effect_building_construction_cost_mod_ship	military_force_building_cost_mod
wh2_dlc11_effect_building_construction_time_mod_all_ship	military_force_building_build_time_mod
wh2_dlc11_effect_economy_gdp_mod_culture	gdp_mod_entertainment
wh2_dlc11_effect_faction_trait_increase_noncoastal_settlement_income	gdp_mod_all
wh2_dlc11_effect_force_all_enemy_campaign_replenishment_rate	replenishment_percentage_bonus
wh2_dlc11_effect_percentage_region_income	percentage_of_region_gdp_leeching
wh2_dlc11_enable_immortal_hidden	immortal
wh2_dlc12_effect_remove_under_empire_visibility	foreign_slot_building_denies_line_of_sight
wh2_dlc13_effect_merc_xp	mercenary_unit_exp_mod
wh2_dlc14_effect_disable_unit_recruitment_points	recruitment_points
wh2_dlc14_effect_line_of_sight_mod_region	line_of_sight_extension
wh2_dlc14_effect_plague_infectivity_mod_skrolk	plague_infection_chance_mod
wh2_dlc14_faction_trait_malus_darkblade_mine_income	gdp_mod_mining
wh2_dlc15_effect_athel_tamarha_prison_2	prison_cell_count_mod
wh2_dlc15_effect_character_xp_steal	percentage_of_xp_to_steal_from_characters_of_same_type
wh2_dlc15_effect_force_unit_stat_melee_defence_lucky	melee_defence_mod
wh2_dlc15_effect_magic_resistance_removed	damage_resistance_magic_mod
wh2_dlc15_enemy_fire_resistance	damage_resistance_flame_mod
wh2_dlc16_effect_ap_damage	melee_damage_ap_mod_mult
wh2_dlc16_effect_economy_gdp_mod_animal_husbandry_wef	gdp_mod_animal_husbandry
wh2_dlc16_effect_economy_gdp_mod_industry_wef	gdp_mod_manufacture
wh2_dlc16_effect_force_enemy_campaign_movement_range_all_regions	mod_land_movement_campaign
wh2_dlc16_effect_increased_rank_spirits	mercenary_unit_exp_mod
wh2_dlc16_effect_line_of_sight_mod_all_regions	line_of_sight_extension
wh2_dlc16_effect_reduced_wild_spirit_cost	mercenary_cost_mod
wh2_dlc16_effect_replenishment_in_foreign_territory	unrestricted_replenishment_bonus
wh2_dlc16_effect_stat_mod_ap_damage_missile_additive	missile_damage_ap_mod_add
wh2_dlc16_effect_stealth_bonus	stealth_mod
wh2_dlc16_effect_throt_flesh_lab_merc_recruit_rank	mercenary_unit_exp_mod
wh2_dlc16_effect_weakness_to_fire	damage_resistance_flame_mod
wh2_dlc16_throt_flesh_lab_growth_vat_recycle_cancel	unit_purchasable_effects_refund_disabled
wh2_dlc16_throt_flesh_lab_growth_vat_recycle_cancel	unit_refund_disabled
wh2_dlc16_throt_flesh_lab_upgrade_cost	unit_purchasable_effect_cost_percentage_mod
wh2_dlc16_wef_aspect_cost_reduction	unit_purchasable_effect_cost_percentage_mod
wh2_dlc17_bst_ritual_herdstone_upgrade_1	occupation_primary_slot_level_mod
wh2_dlc17_bst_ritual_herdstone_upgrade_2	occupation_primary_slot_level_mod
wh2_dlc17_bst_ritual_herdstone_upgrade_3	occupation_primary_slot_level_mod
wh2_dlc17_bst_ritual_herdstone_upgrade_4	occupation_primary_slot_level_mod
wh2_dlc17_effect_ambush_visibility_reduced	stealth_mod
wh2_dlc17_effect_force_all_campaign_replenishment_rate_horde_hidden	unrestricted_replenishment_bonus
wh2_dlc17_effect_force_all_campaign_replenishment_rate_horde	unrestricted_replenishment_bonus
wh2_dlc17_effect_force_all_campaign_sacking_income_nakai	sacking_mod
wh2_dlc17_effect_force_army_battle_enemy_unit_melee_attack	melee_attack_mod
wh2_dlc17_effect_force_army_battle_enemy_unit_melee_defence	melee_defence_mod
wh2_dlc17_effect_force_campaign_stance_begin_fatigued_2_active	unit_starting_fatigue_state
wh2_dlc17_effect_force_stat_mod_ward_save_physical_enemy_army	damage_resistance_physical_mod
wh2_dlc17_effect_global_geomancy	geomancy
wh2_dlc17_effect_global_recruitment_duration_all_hidden	global_recruit_time_mod_land
wh2_dlc17_effect_post_battle_income_hidden	post_battle_loot_mod
wh2_dlc17_effect_raise_dead_recruitment_rank_mod	mercenary_unit_exp_mod
wh2_dlc17_effect_siege_tower_missile_attack_rate_enemy	tower_reload_mod
wh2_dlc17_effect_siege_tower_missile_damage_enemy	tower_damage_mod
wh2_dlc17_effect_wandering_slayers_replenishment_high	faction_mercenary_pool_replenishment_mod
wh2_dlc17_effect_wandering_slayers_replenishment_low	faction_mercenary_pool_replenishment_mod
wh2_dlc17_effect_wandering_slayers_replenishment_medium	faction_mercenary_pool_replenishment_mod
wh2_dlc17_effect_wandering_slayers_replenishment_very_high	faction_mercenary_pool_replenishment_mod
wh2_dlc17_ror_recruitment_cost_mod	mercenary_cost_mod
wh2_main_effect_agent_action_failure_cost_mod	agent_action_failure_cost_mod
wh2_main_effect_agent_action_passive_boost_income_effect_negative	gdp_mod_all
wh2_main_effect_agent_action_passive_boost_income_effect_positive	gdp_mod_all
wh2_main_effect_agent_action_passive_increase_slave_income_effect	province_slaves_slave_gdp_mod_all_income_bonus_modifier
wh2_main_effect_agent_action_success_chance_enemies_in_region	agent_success_chance_mod
wh2_main_effect_army_ability_enable_bloodwrack_cauldron	military_force_ability_strength
wh2_main_effect_army_ability_enable_bolt_of_spite	military_force_ability_strength
wh2_main_effect_army_ability_enable_brazen_cauldron	military_force_ability_strength
wh2_main_effect_army_ability_enable_khaines_flail	military_force_ability_strength
wh2_main_effect_army_ability_enable_khaines_lash	military_force_ability_strength
wh2_main_effect_army_ability_enable_khaines_scourge	military_force_ability_strength
wh2_main_effect_army_ability_enable_sky_cauldron	military_force_ability_strength
wh2_main_effect_army_ability_enable_soul_rain	military_force_ability_strength
wh2_main_effect_army_ability_enable_soul_storm	military_force_ability_strength
wh2_main_effect_army_ability_enable_soul_torrent	military_force_ability_strength
wh2_main_effect_blark_soi_replenishment	replenishment_percentage_bonus
wh2_main_effect_building_construction_time_mod_all	mod_build_time
wh2_main_effect_captives_unit_xp	unit_xp_mod_training
wh2_main_effect_character_mod_loyalty_all	loyalty_initial_mod
wh2_main_effect_economy_gdp_mod_culture_hef	gdp_mod_entertainment
wh2_main_effect_economy_gdp_mod_farming_vmp	gdp_mod_farming
wh2_main_effect_economy_gdp_mod_industry_hef	gdp_mod_manufacture
wh2_main_effect_economy_gdp_mod_slaves_def	gdp_mod_slaves
wh2_main_effect_economy_gdp_mod_trade_local	gdp_mod_local_trade
wh2_main_effect_economy_gdp_mod_trade_sea_global	gdp_mod_sea_trade
wh2_main_effect_economy_gdp_slaves_def	gdp_slaves
wh2_main_effect_faction_trait_unit_recruitment_duration_all	recruit_time_mod_land
wh2_main_effect_force_all_campaign_sacking_income	looting_mod
wh2_main_effect_force_all_campaign_sacking_income	sacking_mod
wh2_main_effect_force_enemy_campaign_movement_range	mod_land_movement_campaign
wh2_main_effect_force_own_campaign_movement_range	mod_land_movement_campaign
wh2_main_effect_force_stat_weapon_strength_base	melee_damage_mod_add
wh2_main_effect_geomancy_building_dummy	geomancy
wh2_main_effect_grant_immortality_character	immortal
wh2_main_effect_grant_immortality_hero	immortal
wh2_main_effect_grant_immortality_lord	immortal
wh2_main_effect_hef_influence_gain	influence
wh2_main_effect_hef_influence_intrigue_cost_mod	diplomatic_relations_influence_cost_mod
wh2_main_effect_percentage_of_xp_to_give_other_characters_of_same_type_hidden	percentage_of_xp_to_give_other_characters_of_same_type
wh2_main_effect_percentage_of_xp_to_steal_from_characters_of_same_type_hidden	percentage_of_xp_to_steal_from_characters_of_same_type
wh2_main_effect_plague_infectivity_mod_good	plague_infection_chance_mod
wh2_main_effect_plague_infectivity_mod_hidden	plague_infection_chance_mod
wh2_main_effect_plague_infectivity_mod	plague_infection_chance_mod
wh2_main_effect_plague_lifetime_bad	plague_infection_duration_mod
wh2_main_effect_plague_lifetime_good	plague_infection_duration_mod
wh2_main_effect_plague_lifetime_mod_good	plague_infection_duration_percentage_mod
wh2_main_effect_plague_lifetime_mod	plague_infection_duration_percentage_mod
wh2_main_effect_research_cost_mod	research_cost_mod
wh2_main_effect_slave_public_order_modifier	province_slaves_slave_public_order_modifier
wh2_main_effect_stance_line_of_sight_mod	line_of_sight_extension
wh2_main_effect_technology_economy_gdp_mod_culture_mining_empire	gdp_mod_entertainment
wh2_main_effect_technology_economy_gdp_mod_culture_mining_empire	gdp_mod_mining
wh2_main_effect_technology_economy_gdp_mod_dyes_pottery_salt_brt	gdp_mod_local_trade
wh2_main_effect_technology_economy_gdp_mod_mining_brt	gdp_mod_mining
wh2_main_effect_technology_economy_gdp_mod_mining_lzd	gdp_mod_mining
wh2_main_effect_technology_economy_gdp_mod_timber_brt	gdp_mod_animal_husbandry
wh2_main_effect_tower_projectile_def_2	autoresolver_tower_level
wh2_main_effect_tower_projectile_def_3	autoresolver_tower_level
wh2_main_effect_tower_projectile_def_4	autoresolver_tower_level
wh2_main_effect_tower_projectile_hef_2	autoresolver_tower_level
wh2_main_effect_tower_projectile_hef_3	autoresolver_tower_level
wh2_main_effect_tower_projectile_hef_4	autoresolver_tower_level
wh2_main_effect_tower_projectile_lzd_2	autoresolver_tower_level
wh2_main_effect_tower_projectile_lzd_3	autoresolver_tower_level
wh2_main_effect_tower_projectile_lzd_4	autoresolver_tower_level
wh2_main_effect_tower_projectile_skv_2	autoresolver_tower_level
wh2_main_effect_tower_projectile_skv_3	autoresolver_tower_level
wh2_main_effect_tower_projectile_skv_4	autoresolver_tower_level
wh2_twa03_effect_blood_voyage_foreign_replenishment	unrestricted_replenishment_bonus
wh2_twa03_effect_rakarth_merc_pool_recruit_ranks_hidden	mercenary_unit_exp_mod
wh2_twa03_plague_duration_mod_hidden	plague_infection_duration_percentage_mod
wh3_dlc20_effect_character_xp_share_leadertext	percentage_of_xp_to_give_other_characters_of_same_type
wh3_dlc20_effect_chs_souls_gift_of_azazel_mod	faction_character_tag_level_mod
wh3_dlc20_effect_daemonic_khorne	damage_resistance_physical_mod
wh3_dlc20_effect_daemonic_nurgle	damage_resistance_physical_mod
wh3_dlc20_effect_daemonic_slaanesh	damage_resistance_physical_mod
wh3_dlc20_effect_daemonic_tzeentch	damage_resistance_physical_mod
wh3_dlc20_effect_daemonic_undivided	damage_resistance_physical_mod
wh3_dlc20_effect_economy_gdp_entertainment	gdp_entertainment
wh3_dlc20_effect_economy_gdp_manufacture	gdp_manufacture
wh3_dlc20_effect_economy_gdp_mod_all	gdp_mod_all
wh3_dlc20_effect_economy_gdp_mod_entertainment	gdp_mod_entertainment
wh3_dlc20_effect_economy_gdp_mod_manufacture	gdp_mod_manufacture
wh3_dlc20_effect_economy_gdp_mod_worship	gdp_mod_mining
wh3_dlc20_effect_economy_gdp_worship	gdp_mining
wh3_dlc20_effect_enables_warpflame_attacks	unit_flaming_attack_mod
wh3_dlc20_effect_healing_cap_modifier	battle_healing_cap_mod
wh3_dlc20_effect_increased_rank_woc_recruitment_panel	mercenary_unit_exp_mod
wh3_dlc20_effect_pooled_resource_mod_souls_battle	post_battle_pooled_resource_loot_percentage_mod
wh3_dlc20_effect_scale_hidden	model_scale_mod
wh3_dlc20_effect_scale_hidden	unit_mass_percentage_mod
wh3_dlc20_effect_souls_received_from_own_casualties	post_battle_casualty_resource_percentage_mod
wh3_dlc23_effect_building_cyclical_construction_time_mod_all	building_lifecycle_stage_duration_mod
wh3_dlc23_effect_caravan_cargo_cost_percentage_modifier	caravan_cargo_cost_percentage_mod
wh3_dlc23_effect_chd_faction_effect_rush_construction_astragoth	building_instant_construction_cost_percentage_mod
wh3_dlc23_effect_chd_toz_income_gdp_mod_dummy	gdp_mod_other
wh3_dlc23_effect_convoy_cargo_capacity	caravan_cargo_capacity_percentage_mod
wh3_dlc23_effect_economy_gpd_manufacture	gdp_mod_manufacture
wh3_dlc23_effect_force_all_campaign_post_battle_loot_mod_base	base_post_battle_loot_mod
wh3_dlc23_effect_force_chd_campaign_post_battle_labour	post_battle_pooled_resource_loot_percentage_mod
wh3_dlc23_effect_rush_construction_cost	building_instant_construction_cost_percentage_mod
wh3_dlc23_effect_rush_construction_slave_cost	building_instant_construction_cost_percentage_mod
wh3_dlc23_effect_technology_chd_convoy_mod_active_convoys	maximum_caravans_mod
wh3_dlc23_effect_technology_gdp_mining_manufacture_mod_chd_resource_gold_gem	gdp_mod_manufacture
wh3_dlc23_effect_technology_gdp_mining_manufacture_mod_chd_resource_gold_gem	gdp_mod_mining
wh3_dlc23_effect_technology_gdp_subsistance_chd_scavengers	gdp_subsistence
wh3_dlc24_effect_building_construction_cost_mod_all_compass	building_conversion_cost_mod
wh3_dlc24_effect_building_construction_cost_mod_all_compass	building_cost_mod
wh3_dlc24_effect_building_construction_time_add_mod_all_compass	add_build_time
wh3_dlc24_effect_changeling_transformation_abilities_unlock	enable_transform_unit_non_spell_abilities
wh3_dlc24_effect_changeling_transformation_spells_unlock	enable_transform_unit_spell_abilities
wh3_dlc24_effect_character_stat_bonus_vs_infantry_removal	damage_vs_infantry
wh3_dlc24_effect_character_stat_bonus_vs_large_removal	damage_vs_large_entities
wh3_dlc24_effect_cth_caravan_mod_active_caravans	maximum_caravans_mod
wh3_dlc24_effect_dragon_river_immortal	immortal
wh3_dlc24_effect_force_stat_armour_enemy	armour_mod
wh3_dlc24_effect_force_stat_mod_all_saves_resistances_enemy	damage_resistance_all_mod
wh3_dlc24_effect_force_stat_mod_all_saves_resistances_enemy	damage_resistance_flame_mod
wh3_dlc24_effect_force_stat_mod_all_saves_resistances_enemy	damage_resistance_magic_mod
wh3_dlc24_effect_force_stat_mod_all_saves_resistances_enemy	damage_resistance_missile_mod
wh3_dlc24_effect_force_stat_mod_all_saves_resistances_enemy	damage_resistance_physical_mod
wh3_dlc24_effect_hide_local_own_armies_bad	hide_local_own_armies
wh3_dlc24_effect_hide_local_own_armies_hidden	hide_local_own_armies
wh3_dlc24_effect_hide_local_own_armies_raiding	hide_local_own_armies
wh3_dlc24_effect_post_battle_tze_grimoires	post_battle_pooled_resource_loot_percentage_mod
wh3_dlc24_effect_technology_research_points_high_priority	research_points
wh3_dlc24_faction_trait_the_changeling_recruit	enable_replenishment_in_foreign_territory
wh3_dlc24_tze_changeling_does_not_attack_settlements_with_foreign_slots_hidden	cai_hint_does_not_attack_settlements_containing_our_foreign_slots
wh3_dlc24_unit_stat_bonus_ammunition	unit_stat_bonus_ammunition
wh3_dlc24_unit_stat_bonus_armour	unit_stat_bonus_armour
wh3_dlc24_unit_stat_bonus_attack	unit_stat_bonus_attack
wh3_dlc24_unit_stat_bonus_defence	unit_stat_bonus_defence
wh3_dlc24_unit_stat_bonus_weapon	unit_stat_bonus_weapon
wh3_dlc25_effect_agent_movement_range_mod_hidden	general_admiral_action_point_bonus
wh3_dlc25_effect_building_army_xp_gain	unit_xp_mod_training
wh3_dlc25_effect_character_stat_ap_missile_damage_flat	missile_damage_ap_mod_add
wh3_dlc25_effect_com_ritual_barrier	battle_barrier_health
wh3_dlc25_effect_com_ritual_corrosion	armour_mod
wh3_dlc25_effect_emp_post_battle_schematics	post_battle_pooled_resource_loot_percentage_mod
wh3_dlc25_effect_emp_research_rate	research_rate_mod
wh3_dlc25_effect_enemy_healing_cap_modifier	battle_healing_cap_mod
wh3_dlc25_effect_force_all_campaign_movement_range_sphere_hidden	mod_land_movement_campaign
wh3_dlc25_effect_force_all_campaign_movement_range_sphere_hidden	mod_ship_movement_campaign
wh3_dlc25_effect_force_all_campaign_replenishment_rate_sphere_hidden	replenishment_percentage_bonus
wh3_dlc25_effect_force_army_campaign_enable_replenishment_in_foreign_territory_hidden	enable_replenishment_in_foreign_territory
wh3_dlc25_effect_force_emp_post_battle_arcane_essays_hidden	post_battle_pooled_resource_loot_percentage_mod
wh3_dlc25_effect_force_emp_post_battle_arcane_essays	post_battle_pooled_resource_loot_percentage_mod
wh3_dlc25_effect_force_stat_leadership_enemy_unit_hidden	morale
wh3_dlc25_effect_hero_emp_post_battle_arcane_essays_hidden	post_battle_pooled_resource_loot_percentage_mod
wh3_dlc25_effect_nur_rush_cycle_cost	building_instant_construction_cost_percentage_mod
wh3_dlc25_effect_plague_apoptosis_mod_faction	plague_creation_infection_chance_reduction_mod
wh3_dlc25_effect_plague_immunity_duration_base_dummy	plague_infection_immunity_duration_mod
wh3_dlc25_effect_plague_immunity_mod_bad_faction_global	plague_creation_immunity_duration_mod
wh3_dlc25_effect_plague_immunity_mod_bad_faction	plague_creation_immunity_duration_mod
wh3_dlc25_effect_plague_immunity_mod_bad	plague_infection_immunity_duration_mod
wh3_dlc25_effect_plague_immunity_mod_good	plague_infection_immunity_duration_mod
wh3_dlc25_effect_plague_infectivity_mod_good_faction	plague_creation_infection_chance_mod
wh3_dlc25_effect_plague_lifetime_good_faction	plague_creation_duration_mod
wh3_dlc25_effect_technology_economy_gdp_mod_local_trade	gdp_mod_local_trade
wh3_dlc25_effect_trespass_immunity_for_army	excluded_from_trespassing
wh3_dlc25_nur_chieftain_ritual_ability_enable_replenishment_scripted	enable_replenishment_in_foreign_territory
wh3_dlc25_nur_chieftain_ritual_ability_force_movement_range_region_scripted	mod_land_movement_campaign
wh3_dlc25_nur_chieftain_ritual_ability_replenishment_full	unrestricted_replenishment_bonus
wh3_dlc25_nur_chieftain_ritual_ability_replenishment_rate_scripted	unrestricted_replenishment_bonus
wh3_dlc26_effect_arbaal_battle_khorne_favour	post_battle_pooled_resource_loot_percentage_mod
wh3_dlc26_effect_block_occupation_beastmen	block_region_occupation
wh3_dlc26_effect_block_occupation_khorne	block_region_occupation
wh3_dlc26_effect_construction_cost_meat_ogre_camps_buildings	military_force_building_cost_mod
wh3_dlc26_effect_enemy_character_wound_recovery_time_mod	recuperation_time_mod
wh3_dlc26_effect_force_all_campaign_movement_range_arbaal_factionwide	mod_land_movement_campaign
wh3_dlc26_effect_force_all_campaign_movement_range_arbaal_factionwide	mod_ship_movement_campaign
wh3_dlc26_effect_force_all_campaign_post_battle_loot_mod_alt_scope	post_battle_loot_mod
wh3_dlc26_effect_force_all_campaign_raid_income_sphere_hidden	raid_income_mod
wh3_dlc26_effect_force_all_campaign_razing_income_alt_scope	razing_mod
wh3_dlc26_effect_force_all_campaign_replenishment_rate	replenishment_percentage_bonus
wh3_dlc26_effect_force_all_campaign_sacking_income_alt_scope	looting_mod
wh3_dlc26_effect_force_all_campaign_sacking_income_alt_scope	sacking_mod
wh3_dlc26_effect_force_campaign_stance_tunnelling_attack_movement	tunnel_attack_characters
wh3_dlc26_effect_ogr_postbattle_meat_alt_scope	post_battle_pooled_resource_loot_percentage_mod
wh3_dlc26_effect_ogr_postbattle_meat_hidden_alt_scope	post_battle_pooled_resource_loot_percentage_mod
wh3_dlc26_effect_ogr_postbattle_meat_hidden	post_battle_pooled_resource_loot_percentage_mod
wh3_dlc26_effect_scrap_cost_increase_hidden	unit_purchasable_effect_cost_mod
wh3_dlc26_effect_stance_campaign_stance_tunnelling_attack	tunnel_attack_characters
wh3_dlc26_effect_stat_incoming_healing_mod	heal_power_percent_mod
wh3_main_disallow_region_for_region_trading	campaign_diplomacy_hint_disallow_region_for_region_trading
wh3_main_effect_allegiance_points_loan_army_mod	army_loaning_cost_percentage_mod
wh3_main_effect_allegiance_points_mod	favour_points_generation_percentage_mod
wh3_main_effect_allegiance_points_war_coordination_target_mod	issue_defensive_military_force_target_cost_percentage_mod
wh3_main_effect_allegiance_points_war_coordination_target_mod	issue_defensive_region_target_cost_percentage_mod
wh3_main_effect_allegiance_points_war_coordination_target_mod	issue_offensive_military_force_target_cost_percentage_mod
wh3_main_effect_allegiance_points_war_coordination_target_mod	issue_offensive_region_target_cost_percentage_mod
wh3_main_effect_allied_recruitment_global_pool_cost_percentage_mod	allied_recruitment_cost_percentage_mod
wh3_main_effect_allied_recruitment_level	allied_recruitment_level
wh3_main_effect_allied_recruitment_outside_allied_territory_cost_percentage_mod_OUTPOSTS	allied_recruitment_outside_allied_territory_cost_percentage_mod
wh3_main_effect_allied_recruitment_outside_allied_territory_cost_percentage_mod	allied_recruitment_outside_allied_territory_cost_percentage_mod
wh3_main_effect_allied_recruitment_points	allied_recruitment_points_mod
wh3_main_effect_allied_recruitment_unit_cap	allied_recruitment_unit_cap_mod
wh3_main_effect_army_xp_gain_including_garrisons	unit_xp_mod_training
wh3_main_effect_army_xp_gain_including_garrisons	unit_xp_mod_training_garrison
wh3_main_effect_battle_barrier_health_add	battle_barrier_health
wh3_main_effect_book_of_khorne_block_occupation	block_region_occupation
wh3_main_effect_building_construction_time_add_mod_all	add_build_time
wh3_main_effect_campaign_compass_coodown_mod	wom_compass_selection_cooldown_mod
wh3_main_effect_caravan_cargo_banditry	caravan_banditry_percentage_mod
wh3_main_effect_caravan_cargo_capacity	caravan_cargo_capacity_percentage_mod
wh3_main_effect_caravan_cargo_value_regions	caravan_cargo_value_percentage_mod
wh3_main_effect_caravan_cargo_value	caravan_cargo_value_percentage_mod
wh3_main_effect_character_stat_missile_damage_base_add	missile_damage_mod_add
wh3_main_effect_character_stat_missile_damage_base	missile_damage_mod_mult
wh3_main_effect_character_stat_unit_mass_percentage_mod	unit_mass_percentage_mod
wh3_main_effect_character_xp_share_generic_herotext	percentage_of_xp_to_give_other_characters_of_same_type
wh3_main_effect_character_xp_share_generic_lordtext	percentage_of_xp_to_give_other_characters_of_same_type
wh3_main_effect_combat_potential_melee_bonus	combat_potential_melee
wh3_main_effect_combat_potential_melee_percentage_mod	combat_potential_melee_mod
wh3_main_effect_combat_potential_ranged_bonus	combat_potential_ranged
wh3_main_effect_combat_potential_ranged_percentage_mod	combat_potential_ranged_mod
wh3_main_effect_economy_gdp_mod_kho_advanced_recruitment	gdp_mod_mining
wh3_main_effect_economy_gdp_mod_kho_basic_recruitment	gdp_mod_manufacture
wh3_main_effect_economy_gdp_mod_manufacture	gdp_mod_manufacture
wh3_main_effect_economy_gdp_mod_ogr_manufacture	gdp_mod_manufacture
wh3_main_effect_economy_gdp_mod_ogr_manufacture	gdp_mod_sea_trade
wh3_main_effect_economy_gdp_mod_slaves	gdp_mod_other
wh3_main_effect_economy_gdp_slaves	gdp_other
wh3_main_effect_factions_global_strength_should_be_ignored_in_strategic_evaluations	cai_hint_factions_global_strenth_should_be_ignored_in_strategic_evaluations
wh3_main_effect_fellblade_penalty	battle_healing_cap_mod
wh3_main_effect_fellblade_penalty	replenishment_percentage_bonus
wh3_main_effect_force_all_campaign_movement_range_disabled_during_cast_time	character_movement_disabled
wh3_main_effect_force_all_campaign_movement_range_disabled	character_movement_disabled
wh3_main_effect_force_all_seduce_units_budget_enemy	bribe_budget_limit_percentage_mod
wh3_main_effect_force_all_seduce_units_budget_hidden	bribe_budget_limit_percentage_mod
wh3_main_effect_force_all_seduce_units_budget	bribe_budget_limit_percentage_mod
wh3_main_effect_force_all_summon_disciple_army_budget	spawnable_force_budget_percentage_mod
wh3_main_effect_force_army_campaign_replenish_in_foreign_territory	enable_replenishment_in_foreign_territory
wh3_main_effect_force_stat_accuracy	unit_stat_bonus_accuracy_mod
wh3_main_effect_force_stat_melee_defence_mult	melee_defence_mod_mult
wh3_main_effect_force_stat_unit_mass_percentage_mod	unit_mass_percentage_mod
wh3_main_effect_garrison_attack_range	garrison_attack_range
wh3_main_effect_hordebuilding_growth_core_camp	military_force_development_growth_core
wh3_main_effect_hordebuilding_growth_events_camps	military_force_development_growth_events
wh3_main_effect_ice_court_training_cost_mod	character_training_cost_percentage_mod
wh3_main_effect_ignore_climate_penalties	ignore_climate_bundle
wh3_main_effect_increase_mercenary_pool_cap	mercenary_faction_pool_cap_mod
wh3_main_effect_is_rift_faction	cai_hint_is_rift_faction
wh3_main_effect_kho_post_battle_skull_income	post_battle_casualty_resource_percentage_mod
wh3_main_effect_mercenary_cost_mod	mercenary_cost_mod
wh3_main_effect_ogr_camp_disable_meat_upkeep	resource_upkeep_disabled
wh3_main_effect_ogr_camp_meat_sphere_of_influence	resource_upkeep_disabled
wh3_main_effect_opposing_reinforcement_time_percentage_mod	opponents_reinforcement_arrival_time_percentage_mod
wh3_main_effect_own_reinforcement_time_percentage_mod	own_reinforcement_arrival_time_percentage_mod
wh3_main_effect_percentage_region_income_dwf	percentage_of_region_gdp_leeching
wh3_main_effect_pre_battle_bribery_cost_mod	bribery_cost_percentage_mod
wh3_main_effect_prestige_from_battles	post_battle_pooled_resource_loot_percentage_mod
wh3_main_effect_recruitment_cost_ogre_mercenaries	mercenary_cost_mod
wh3_main_effect_reinforcement_adjustment_budget	reinforcement_arrival_point_change_cost_threshold
wh3_main_effect_replenish_in_foreign_territory_neutraltext	enable_replenishment_in_foreign_territory
wh3_main_effect_sla_devotees_gift_of_slaanesh_mod	faction_character_tag_level_mod
wh3_main_effect_technology_research_rate_mod_hidden	research_points
wh3_main_effect_tower_projectile_chs_2	autoresolver_tower_level
wh3_main_effect_tower_projectile_chs_3	autoresolver_tower_level
wh3_main_effect_tower_projectile_chs_4	autoresolver_tower_level
wh3_main_effect_tower_projectile_cth_2	autoresolver_tower_level
wh3_main_effect_tower_projectile_cth_3	autoresolver_tower_level
wh3_main_effect_tower_projectile_cth_4	autoresolver_tower_level
wh3_main_effect_tower_projectile_kho_2	autoresolver_tower_level
wh3_main_effect_tower_projectile_kho_3	autoresolver_tower_level
wh3_main_effect_tower_projectile_kho_4	autoresolver_tower_level
wh3_main_effect_tower_projectile_ksl_2	autoresolver_tower_level
wh3_main_effect_tower_projectile_ksl_3	autoresolver_tower_level
wh3_main_effect_tower_projectile_ksl_4	autoresolver_tower_level
wh3_main_effect_tower_projectile_nur_2	autoresolver_tower_level
wh3_main_effect_tower_projectile_nur_3	autoresolver_tower_level
wh3_main_effect_tower_projectile_nur_4	autoresolver_tower_level
wh3_main_effect_tower_projectile_sla_2	autoresolver_tower_level
wh3_main_effect_tower_projectile_sla_3	autoresolver_tower_level
wh3_main_effect_tower_projectile_sla_4	autoresolver_tower_level
wh3_main_effect_tower_projectile_tze_2	autoresolver_tower_level
wh3_main_effect_tower_projectile_tze_3	autoresolver_tower_level
wh3_main_effect_tower_projectile_tze_4	autoresolver_tower_level
wh3_main_effect_unfortified_settlement_battle_pathway	unfortified_settlement_starts_siege_battle
wh3_main_effect_unfortified_settlement_battle_walls	unfortified_settlement_starts_siege_battle
wh3_main_effect_unfortified_settlement_battle	unfortified_settlement_starts_siege_battle
wh3_main_effect_winds_of_magic_change_chance_mod_HIDDEN	winds_of_magic_change_chance_mod
wh3_main_effect_winds_of_magic_change_chance_mod	winds_of_magic_change_chance_mod
wh3_main_effect_winds_of_magic_compass_decrease	winds_of_magic_increase_chance_mod
wh3_main_effect_winds_of_magic_compass_increase	winds_of_magic_change_chance_mod
wh3_main_effect_winds_of_magic_compass_increase	winds_of_magic_increase_chance_mod
wh3_main_effect_winds_of_magic_increase_chance_mod	winds_of_magic_increase_chance_mod
wh3_main_military_forces_suffers_penalty_at_low_wom	cai_hint_faction_military_forces_suffers_penalty_at_low_wom
wh3_main_skill_tze_kairos_reinforcements_2	opponents_reinforcement_arrival_time_prediction_accuracy_mod
wh3_main_skill_tze_kairos_reinforcements	reinforcement_arrival_point_change_cost_percentage_mod
wh3_main_tech_ogr_postbattle_meat	post_battle_pooled_resource_loot_percentage_mod
wh3_prologue_effect_reduce_line_of_sight	line_of_sight_extension
wh_dlc03_effect_bloodlust_modifier_alliance	military_force_morale_modifier_faction
wh_dlc03_effect_bloodlust_modifier_animosity	military_force_morale_modifier_animosity
wh_dlc03_effect_bloodlust_modifier_characters	military_force_morale_modifier_characters
wh_dlc03_effect_bloodlust_modifier_fortify_stance	military_force_morale_modifier_settle_stance
wh_dlc03_effect_bloodlust_modifier_non_aggression	military_force_morale_modifier_faction
wh_dlc03_effect_bloodlust_modifier_peace	military_force_morale_modifier_animosity
wh_dlc03_effect_bloodlust_modifier_raid_stance	military_force_morale_modifier_raid_stance
wh_dlc03_effect_bloodlust_modifier_siege_stance	military_force_morale_modifier_tax
wh_dlc03_effect_bloodlust_modifier	military_force_morale_modifier_faction
wh_dlc03_effect_force_army_campaign_tunnelling_evasion_chance	tunnel_interception_evasion_chance
wh_dlc03_effect_replenishment_full	unrestricted_replenishment_bonus
wh_dlc03_effect_replenishment_removed	unrestricted_replenishment_bonus
wh_dlc03_effect_stance_ambush_removal_hidden	ambush_chance_of_success_attack_bonus
wh_dlc03_effect_stealth_bonus_hidden	stealth_mod
wh_dlc03_effect_tech_army_campaign_beastpath_evasion_chance	tunnel_interception_evasion_chance
wh_dlc03_effect_technology_research_points_hidden	research_points
wh_dlc04_effect_force_all_campaign_razing_income_hidden	razing_mod
wh_dlc05_effect_amber_building_hidden	food_production_buildings
wh_dlc05_effect_amber_quest_events	food_production_events
wh_dlc05_effect_building_army_xp_gain	unit_xp_mod_training
wh_dlc05_effect_building_global_recruitment_duration	global_recruit_time_mod_land
wh_dlc05_effect_economy_gdp_mod_wines	gdp_mod_farming
wh_dlc05_effect_faction_global_recruitment_points_building	recruitment_points
wh_dlc05_effect_global_recruitment_duration_all	global_recruit_time_mod_land
wh_dlc05_effect_occupation_decision_colonise_cost_increase_hidden	occupation_decision_colonise_cost_mod
wh_dlc05_effect_tech_army_campaign_worldroot_evasion_chance	tunnel_interception_evasion_chance
wh_dlc05_morghur_trait_immortalitiy	recuperation_time_mod
wh_dlc06_effect_enable_magic_attacks_building_hidden	unit_is_magical
wh_dlc06_effect_enable_magic_attacks_building	unit_is_magical
wh_dlc07_effect_economy_gdp_mod_farming	gdp_mod_farming
wh_dlc07_effect_economy_gdp_mod_industry	gdp_mod_manufacture
wh_dlc08_effect_grant_immortality_hero_all	immortal
wh_dlc08_effect_grant_immortality_lord_all	immortal
wh_main_effect_agent_action_outcome_parent_army_xp_gain_factionwide	unit_xp_mod_training
wh_main_effect_agent_action_outcome_parent_army_xp_gain	unit_xp_mod_training
wh_main_effect_agent_field_line_of_sight_mod	line_of_sight_extension
wh_main_effect_agent_movement_range_mod	general_admiral_action_point_bonus
wh_main_effect_blackark_growth_core	military_force_development_growth_core
wh_main_effect_blackark_growth_tech	military_force_development_growth_tech
wh_main_effect_building_construction_cost_mod_all	building_conversion_cost_mod
wh_main_effect_building_construction_cost_mod_all	building_cost_mod
wh_main_effect_building_construction_cost_mod	building_conversion_cost_mod
wh_main_effect_building_construction_cost_mod	building_cost_mod
wh_main_effect_building_road	roads
wh_main_effect_building_trade_route_sea_hidden	trade_route_cap_sea
wh_main_effect_character_mod_ancillary_steal	post_battle_ancillary_steal_chance_mod
wh_main_effect_character_stat_ap_missile_damage	missile_damage_ap_mod_mult
wh_main_effect_character_stat_enable_magic_attacks	unit_is_magical
wh_main_effect_character_stat_missile_block	missile_block_chance_mod
wh_main_effect_character_stat_unit_health	general_bodyguard_size_mod
wh_main_effect_character_wound_recovery_time_mod	recuperation_time_mod
wh_main_effect_conquest_enable_night_battles	can_fight_night_battles
wh_main_effect_conquest_enable_night_battles	can_fight_night_battles_naval
wh_main_effect_conquest_resistance_to_occupation_mod	region_resistance_modifier
wh_main_effect_economy_gdp_agriculture_animal_husbandry	gdp_animal_husbandry
wh_main_effect_economy_gdp_agriculture_farming	gdp_farming
wh_main_effect_economy_gdp_culture	gdp_entertainment
wh_main_effect_economy_gdp_learning	gdp_learning
wh_main_effect_economy_gdp_manufacture_market	gdp_mod_manufacture
wh_main_effect_economy_gdp_manufacture	gdp_manufacture
wh_main_effect_economy_gdp_mining	gdp_mining
wh_main_effect_economy_gdp_mod_agriculture_farming_vampires	gdp_mod_manufacture
wh_main_effect_economy_gdp_mod_agriculture_farming	gdp_mod_farming
wh_main_effect_economy_gdp_mod_all_adjacent_provinces	gdp_mod_all
wh_main_effect_economy_gdp_mod_all_bad	gdp_mod_all
wh_main_effect_economy_gdp_mod_all_compass	gdp_mod_all
wh_main_effect_economy_gdp_mod_all_hidden	gdp_mod_all
wh_main_effect_economy_gdp_mod_all	gdp_mod_all
wh_main_effect_economy_gdp_mod_culture_vampires	gdp_mod_entertainment
wh_main_effect_economy_gdp_mod_livestock_vampires	gdp_mod_animal_husbandry
wh_main_effect_economy_gdp_mod_subsistence	gdp_mod_subsistence
wh_main_effect_economy_gdp_mod_trade_sea	gdp_mod_sea_trade
wh_main_effect_economy_gdp_other	gdp_other
wh_main_effect_economy_gdp_subsistance	gdp_subsistence
wh_main_effect_economy_gdp_trade_land	gdp_land_trade
wh_main_effect_economy_gdp_trade_local	gdp_local_trade
wh_main_effect_economy_gdp_trade_sea	gdp_sea_trade
wh_main_effect_economy_trade_good_commodity_mod	resource_production_mod
wh_main_effect_economy_trade_tariff_mod	trade_income_mod
wh_main_effect_faction_mercenary_levy_can_recruit_from_local_hordes	mercenary_levy_can_recruit_from_local_hordes
wh_main_effect_faction_mercenary_levy_units_per_region_mod	mercenary_levy_units_per_region_mod
wh_main_effect_force_all_campaign_captives	captives_taken_mod
wh_main_effect_force_all_campaign_loot_income	looting_mod
wh_main_effect_force_all_campaign_movement_range_bad	mod_land_movement_campaign
wh_main_effect_force_all_campaign_movement_range	mod_land_movement_campaign
wh_main_effect_force_all_campaign_movement_range	mod_ship_movement_campaign
wh_main_effect_force_all_campaign_post_battle_loot_mod	post_battle_loot_mod
wh_main_effect_force_all_campaign_raid_income	raid_income_mod
wh_main_effect_force_all_campaign_razing_income	razing_mod
wh_main_effect_force_all_campaign_recruitment_cost_all_compass	recruitment_mod_cost_land_all
wh_main_effect_force_all_campaign_recruitment_cost_all	recruitment_mod_cost_land_all
wh_main_effect_force_all_campaign_recruitment_cost_hidden	recruitment_mod_cost_land_all
wh_main_effect_force_all_campaign_recruitment_cost	recruitment_mod_cost_land_all
wh_main_effect_force_all_campaign_reinforcement_range	reinforcement_radius_bonus
wh_main_effect_force_all_campaign_replenishment_rate_compass	replenishment_percentage_bonus
wh_main_effect_force_all_campaign_replenishment_rate_horde	unrestricted_replenishment_bonus
wh_main_effect_force_all_campaign_replenishment_rate	replenishment_percentage_bonus
wh_main_effect_force_all_campaign_sacking_income	sacking_mod
wh_main_effect_force_all_campaign_stance_ap_cost	stance_ap_cost_refundable_on_off
wh_main_effect_force_all_campaign_stance_ap_cost	stance_ap_percentage_cost
wh_main_effect_force_all_recruitment_points	recruitment_points
wh_main_effect_force_army_campaign_ambush_attack_success_chance	ambush_chance_of_success_attack_bonus
wh_main_effect_force_army_campaign_ambush_defence_success_chance_hidden	ambush_chance_of_success_defence_bonus
wh_main_effect_force_army_campaign_ambush_defence_success_chance	ambush_chance_of_success_defence_bonus
wh_main_effect_force_army_campaign_enable_replenishment_in_foreign_territory_encamp_stance	enable_replenishment_in_foreign_territory
wh_main_effect_force_army_campaign_enable_replenishment_in_foreign_territory	enable_replenishment_in_foreign_territory
wh_main_effect_force_army_campaign_movement_range	mod_land_movement_campaign
wh_main_effect_force_army_campaign_recruitment_points	recruitment_points
wh_main_effect_force_army_campaign_tunnelling_evasion_chance	tunnel_interception_evasion_chance
wh_main_effect_force_building_cost_mod	military_force_building_cost_mod
wh_main_effect_force_campaign_stance_begin_fatigued_3_winded	unit_starting_fatigue_state
wh_main_effect_force_campaign_stance_begin_fatigued_4_tired	unit_starting_fatigue_state
wh_main_effect_force_campaign_stance_can_move_extra_stance_display	stance_ap_percentage_increase
wh_main_effect_force_navy_campaign_local_piracy	region_gdp_trade_piracy_effect_mod
wh_main_effect_force_stat_ammunition	ammo_mod
wh_main_effect_force_stat_ap_damage_mult	melee_damage_ap_mod_mult
wh_main_effect_force_stat_ap_damage	melee_damage_ap_mod_add
wh_main_effect_force_stat_ap_missile_damage_mult	missile_damage_ap_mod_mult
wh_main_effect_force_stat_armour_mult	armour_mod_mult
wh_main_effect_force_stat_armour	armour_mod
wh_main_effect_force_stat_charge_bonus_pct	charge_bonus_for_land_units
wh_main_effect_force_stat_enable_magic_attacks	unit_is_magical
wh_main_effect_force_stat_leadership_enemy_unit_compass	morale
wh_main_effect_force_stat_leadership_enemy_unit	morale
wh_main_effect_force_stat_leadership_pct	morale_percentage_mod
wh_main_effect_force_stat_leadership	morale
wh_main_effect_force_stat_melee_attack_pct	melee_attack_mod_mult
wh_main_effect_force_stat_melee_attack	melee_attack_mod
wh_main_effect_force_stat_melee_defence	melee_defence_mod
wh_main_effect_force_stat_reload_time_reduction_tower_siege	tower_reload_mod
wh_main_effect_general_mod_tunnel_interception_chance	tunnel_interception_chance
wh_main_effect_horde_building_gdp_mod_all	gdp_mod_all
wh_main_effect_horde_unit_replenishment_hidden	unrestricted_replenishment_bonus
wh_main_effect_hordebuilding_growth_characters	military_force_development_growth_characters
wh_main_effect_hordebuilding_growth_core	military_force_development_growth_core
wh_main_effect_hordebuilding_growth_events_faction	military_force_development_growth_events
wh_main_effect_hordebuilding_growth_if_settled_stance_variant	military_force_development_growth_stance_settled
wh_main_effect_hordebuilding_growth_stance	military_force_development_growth_stance
wh_main_effect_hordebuilding_growth_tech_camp	military_force_development_growth_tech
wh_main_effect_hordebuilding_growth_tech	military_force_development_growth_tech
wh_main_effect_modify_vassal_income	extra_income_from_vassals
wh_main_effect_occupation_decision_colonise_cost_zero	occupation_decision_colonise_cost_mod
wh_main_effect_province_food_shortage_enable_desertion_attrition_for_own_forces	enable_desertion_attrition_for_own_forces_in_region
wh_main_effect_public_order_neighbouring_wars	province_public_order_happiness_per_war_factor
wh_main_effect_raise_dead_recruitment_cost_mod	mercenary_cost_mod
wh_main_effect_ror_lock	faction_mercenary_pool_cost_mod
wh_main_effect_settlement_walls_hidden	garrison_walls_15m
wh_main_effect_settlement_walls	garrison_walls_15m
wh_main_effect_technology_economy_gdp_mod_culture_dwarfs	gdp_mod_entertainment
wh_main_effect_technology_economy_gdp_mod_livestock_dwarfs	gdp_mod_animal_husbandry
wh_main_effect_technology_economy_gdp_mod_manufacture_dwarfs	gdp_mod_manufacture
wh_main_effect_technology_economy_gdp_mod_mining_dwarfs	gdp_mod_mining
wh_main_effect_technology_economy_gdp_mod_subsistence_dwarfs	gdp_mod_subsistence
wh_main_effect_technology_research_points	research_points
wh_main_effect_technology_research_rate_mod	research_points
wh_main_effect_tower_projectile_brt_2	autoresolver_tower_level
wh_main_effect_tower_projectile_brt_3	autoresolver_tower_level
wh_main_effect_tower_projectile_brt_4	autoresolver_tower_level
wh_main_effect_tower_projectile_dwf_2	autoresolver_tower_level
wh_main_effect_tower_projectile_dwf_3	autoresolver_tower_level
wh_main_effect_tower_projectile_dwf_4	autoresolver_tower_level
wh_main_effect_tower_projectile_emp_2	autoresolver_tower_level
wh_main_effect_tower_projectile_emp_3	autoresolver_tower_level
wh_main_effect_tower_projectile_emp_4	autoresolver_tower_level
wh_main_effect_tower_projectile_grn_2	autoresolver_tower_level
wh_main_effect_tower_projectile_grn_3	autoresolver_tower_level
wh_main_effect_tower_projectile_grn_4	autoresolver_tower_level
wh_main_effect_tower_projectile_vmp_2	autoresolver_tower_level
wh_main_effect_tower_projectile_vmp_3	autoresolver_tower_level
wh_main_effect_tower_projectile_vmp_4	autoresolver_tower_level
wh_main_effect_unit_recruitment_points_compass	recruitment_points
wh_main_effect_unit_recruitment_points	recruitment_points
wh_main_ignore_replenishment_cap	max_replenishment_pct_override
