member	action_result
#campaign_group_member_criteria_action_results_tables;0;db/campaign_group_member_criteria_action_results_tables/data__	
wh2_dlc09_all_agent_action_success_colonise_ruins	wh2_dlc09_agent_action_engineer_hinder_settlement_success_necrotect_ritual
wh2_dlc09_event_feed_agent_action_all_failure_critical_hinder_army_tomb_kings	wh_main_agent_action_all_hinder_army_critical_failure
wh2_dlc09_event_feed_agent_action_all_failure_critical_hinder_character_tomb_kings	wh_main_agent_action_all_hinder_character_critical_failure
wh2_dlc09_event_feed_agent_action_all_failure_critical_hinder_province_tomb_kings	wh_main_agent_action_all_hinder_settlement_critical_failure
wh2_dlc09_event_feed_agent_action_all_failure_hinder_army_tomb_kings	wh_main_agent_action_all_hinder_army_failure
wh2_dlc09_event_feed_agent_action_all_failure_hinder_character_tomb_kings	wh_main_agent_action_all_hinder_character_failure
wh2_dlc09_event_feed_agent_action_all_failure_hinder_province_tomb_kings	wh_main_agent_action_all_hinder_settlement_failure
wh2_dlc09_event_feed_agent_action_all_hinder_character_tomb_kings	wh_main_agent_action_all_hinder_agent_success
wh2_dlc09_event_feed_agent_action_all_success_critical_hinder_character_tomb_kings	wh_main_agent_action_all_hinder_agent_critical_success
wh2_dlc09_event_feed_agent_action_champion_hinder_army_tomb_kings	wh2_main_agent_action_hinder_army_success_assault_units
wh2_dlc09_event_feed_agent_action_champion_hinder_settlement_plague_priest_tomb_kings	wh2_main_agent_action_wizard_hinder_settlement_success_plague_priest_ritual
wh2_dlc09_event_feed_agent_action_champion_hinder_settlement_tomb_kings	wh2_main_agent_action_hinder_settlement_success_assault_garrison
wh2_dlc09_event_feed_agent_action_champion_hinder_settlement_warlock_engineer_tomb_kings	wh2_main_agent_action_engineer_hinder_settlement_success_warlock_engineer_ritual
wh2_dlc09_event_feed_agent_action_dignitary_hinder_army_tomb_kings	wh2_main_agent_action_hinder_army_success_hinder_replenishment
wh2_dlc09_event_feed_agent_action_dignitary_hinder_settlement_tomb_kings	wh2_main_agent_action_hinder_settlement_success_damage_building
wh2_dlc09_event_feed_agent_action_engineer_hinder_settlement_tomb_kings	wh2_main_agent_action_hinder_settlement_success_steal_technology
wh2_dlc09_event_feed_agent_action_hinder_settlement_gain_influence_tomb_kings	wh2_main_agent_action_hinder_settlement_success_gain_influence
wh2_dlc09_event_feed_agent_action_spy_hinder_army_tomb_kings	wh2_main_agent_action_hinder_army_success_block_army
wh2_dlc09_event_feed_agent_action_spy_hinder_settlement_tomb_kings	wh2_main_agent_action_hinder_settlement_success_damage_walls
wh2_dlc09_event_feed_agent_action_wizard_hinder_army_tomb_kings	wh2_main_agent_action_hinder_army_success_assault_unit
wh2_dlc10_event_feed_agent_action_shadow_walker_hinder_character_vampire_coast	wh2_dlc10_agent_action_shadow_walker_hinder_agent_success
wh2_dlc11_event_feed_agent_action_all_failure_critical_hinder_army_vampire_coast	wh_main_agent_action_all_hinder_army_critical_failure
wh2_dlc11_event_feed_agent_action_all_failure_critical_hinder_character_vampire_coast	wh_main_agent_action_all_hinder_character_critical_failure
wh2_dlc11_event_feed_agent_action_all_failure_critical_hinder_province_vampire_coast	wh_main_agent_action_all_hinder_settlement_critical_failure
wh2_dlc11_event_feed_agent_action_all_failure_hinder_army_vampire_coast	wh_main_agent_action_all_hinder_army_failure
wh2_dlc11_event_feed_agent_action_all_failure_hinder_character_vampire_coast	wh_main_agent_action_all_hinder_character_failure
wh2_dlc11_event_feed_agent_action_all_failure_hinder_province_vampire_coast	wh_main_agent_action_all_hinder_settlement_failure
wh2_dlc11_event_feed_agent_action_all_hinder_character_vampire_coast	wh_main_agent_action_all_hinder_agent_success
wh2_dlc11_event_feed_agent_action_all_success_critical_hinder_character_vampire_coast	wh_main_agent_action_all_hinder_agent_critical_success
wh2_dlc11_event_feed_agent_action_champion_hinder_army_vampire_coast	wh2_main_agent_action_hinder_army_success_assault_units
wh2_dlc11_event_feed_agent_action_champion_hinder_settlement_plague_priest_vampire_coast	wh2_main_agent_action_wizard_hinder_settlement_success_plague_priest_ritual
wh2_dlc11_event_feed_agent_action_champion_hinder_settlement_vampire_coast	wh2_main_agent_action_hinder_settlement_success_assault_garrison
wh2_dlc11_event_feed_agent_action_champion_hinder_settlement_warlock_engineer_vampire_coast	wh2_main_agent_action_engineer_hinder_settlement_success_warlock_engineer_ritual
wh2_dlc11_event_feed_agent_action_dignitary_hinder_army_vampire_coast	wh2_main_agent_action_hinder_army_success_hinder_replenishment
wh2_dlc11_event_feed_agent_action_dignitary_hinder_settlement_vampire_coast	wh2_main_agent_action_hinder_settlement_success_damage_building
wh2_dlc11_event_feed_agent_action_engineer_hinder_settlement_vampire_coast	wh2_main_agent_action_hinder_settlement_success_steal_technology
wh2_dlc11_event_feed_agent_action_hinder_settlement_gain_influence_vampire_coast	wh2_main_agent_action_hinder_settlement_success_gain_influence
wh2_dlc11_event_feed_agent_action_spy_hinder_army_vampire_coast	wh2_main_agent_action_hinder_army_success_block_army
wh2_dlc11_event_feed_agent_action_spy_hinder_settlement_vampire_coast	wh2_main_agent_action_hinder_settlement_success_damage_walls
wh2_dlc11_event_feed_agent_action_wizard_hinder_army_vampire_coast	wh2_main_agent_action_hinder_army_success_assault_unit
wh2_dlc12_lzd_kroak_action_success_colossal_deliverance_1	wh2_dlc12_agent_action_kroak_hinder_settlement_success_lord_kroak_success_walls_1
wh2_dlc12_lzd_kroak_action_success_colossal_deliverance_2	wh2_dlc12_agent_action_kroak_hinder_settlement_success_lord_kroak_success_walls_2
wh2_dlc12_lzd_kroak_action_success_ultimate_deliverance	wh2_dlc12_agent_action_kroak_hinder_settlement_success_lord_kroak_success_settlement
wh2_dlc16_wef_ariel_action_success_hinder_settlement	wh2_dlc16_agent_action_wizard_hinder_settlement_success_ariel
wh2_main_all_agent_action_success_cause_earthquake	wh2_main_agent_action_engineer_hinder_settlement_success_warlock_engineer_ritual
wh2_main_event_feed_agent_action_all_failure_critical_hinder_army_dark_elves	wh_main_agent_action_all_hinder_army_critical_failure
wh2_main_event_feed_agent_action_all_failure_critical_hinder_army_high_elves	wh_main_agent_action_all_hinder_army_critical_failure
wh2_main_event_feed_agent_action_all_failure_critical_hinder_army_lizardmen	wh_main_agent_action_all_hinder_army_critical_failure
wh2_main_event_feed_agent_action_all_failure_critical_hinder_army_skaven	wh_main_agent_action_all_hinder_army_critical_failure
wh2_main_event_feed_agent_action_all_failure_critical_hinder_character_dark_elves	wh_main_agent_action_all_hinder_character_critical_failure
wh2_main_event_feed_agent_action_all_failure_critical_hinder_character_high_elves	wh_main_agent_action_all_hinder_character_critical_failure
wh2_main_event_feed_agent_action_all_failure_critical_hinder_character_lizardmen	wh_main_agent_action_all_hinder_character_critical_failure
wh2_main_event_feed_agent_action_all_failure_critical_hinder_character_skaven	wh_main_agent_action_all_hinder_character_critical_failure
wh2_main_event_feed_agent_action_all_failure_critical_hinder_province_dark_elves	wh_main_agent_action_all_hinder_settlement_critical_failure
wh2_main_event_feed_agent_action_all_failure_critical_hinder_province_high_elves	wh_main_agent_action_all_hinder_settlement_critical_failure
wh2_main_event_feed_agent_action_all_failure_critical_hinder_province_lizardmen	wh_main_agent_action_all_hinder_settlement_critical_failure
wh2_main_event_feed_agent_action_all_failure_critical_hinder_province_skaven	wh_main_agent_action_all_hinder_settlement_critical_failure
wh2_main_event_feed_agent_action_all_failure_hinder_army_dark_elves	wh_main_agent_action_all_hinder_army_failure
wh2_main_event_feed_agent_action_all_failure_hinder_army_high_elves	wh_main_agent_action_all_hinder_army_failure
wh2_main_event_feed_agent_action_all_failure_hinder_army_lizardmen	wh_main_agent_action_all_hinder_army_failure
wh2_main_event_feed_agent_action_all_failure_hinder_army_skaven	wh_main_agent_action_all_hinder_army_failure
wh2_main_event_feed_agent_action_all_failure_hinder_character_dark_elves	wh_main_agent_action_all_hinder_character_failure
wh2_main_event_feed_agent_action_all_failure_hinder_character_high_elves	wh_main_agent_action_all_hinder_character_failure
wh2_main_event_feed_agent_action_all_failure_hinder_character_lizardmen	wh_main_agent_action_all_hinder_character_failure
wh2_main_event_feed_agent_action_all_failure_hinder_character_skaven	wh_main_agent_action_all_hinder_character_failure
wh2_main_event_feed_agent_action_all_failure_hinder_province_dark_elves	wh_main_agent_action_all_hinder_settlement_failure
wh2_main_event_feed_agent_action_all_failure_hinder_province_high_elves	wh_main_agent_action_all_hinder_settlement_failure
wh2_main_event_feed_agent_action_all_failure_hinder_province_lizardmen	wh_main_agent_action_all_hinder_settlement_failure
wh2_main_event_feed_agent_action_all_failure_hinder_province_skaven	wh_main_agent_action_all_hinder_settlement_failure
wh2_main_event_feed_agent_action_all_hinder_character_dark_elves	wh_main_agent_action_all_hinder_agent_success
wh2_main_event_feed_agent_action_all_hinder_character_high_elves	wh_main_agent_action_all_hinder_agent_success
wh2_main_event_feed_agent_action_all_hinder_character_lizardmen	wh_main_agent_action_all_hinder_agent_success
wh2_main_event_feed_agent_action_all_hinder_character_skaven	wh_main_agent_action_all_hinder_agent_success
wh2_main_event_feed_agent_action_all_success_critical_hinder_character_dark_elves	wh_main_agent_action_all_hinder_agent_critical_success
wh2_main_event_feed_agent_action_all_success_critical_hinder_character_high_elves	wh_main_agent_action_all_hinder_agent_critical_success
wh2_main_event_feed_agent_action_all_success_critical_hinder_character_lizardmen	wh_main_agent_action_all_hinder_agent_critical_success
wh2_main_event_feed_agent_action_all_success_critical_hinder_character_skaven	wh_main_agent_action_all_hinder_agent_critical_success
wh2_main_event_feed_agent_action_champion_hinder_army_dark_elves	wh2_main_agent_action_hinder_army_success_assault_units
wh2_main_event_feed_agent_action_champion_hinder_army_high_elves	wh2_main_agent_action_hinder_army_success_assault_units
wh2_main_event_feed_agent_action_champion_hinder_army_lizardmen	wh2_main_agent_action_hinder_army_success_assault_units
wh2_main_event_feed_agent_action_champion_hinder_army_skaven	wh2_main_agent_action_hinder_army_success_assault_units
wh2_main_event_feed_agent_action_champion_hinder_settlement_dark_elves	wh2_main_agent_action_hinder_settlement_success_assault_garrison
wh2_main_event_feed_agent_action_champion_hinder_settlement_high_elves	wh2_main_agent_action_hinder_settlement_success_assault_garrison
wh2_main_event_feed_agent_action_champion_hinder_settlement_lizardmen	wh2_main_agent_action_hinder_settlement_success_assault_garrison
wh2_main_event_feed_agent_action_champion_hinder_settlement_plague_priest_dark_elves	wh2_main_agent_action_wizard_hinder_settlement_success_plague_priest_ritual
wh2_main_event_feed_agent_action_champion_hinder_settlement_plague_priest_high_elves	wh2_main_agent_action_wizard_hinder_settlement_success_plague_priest_ritual
wh2_main_event_feed_agent_action_champion_hinder_settlement_plague_priest_lizardmen	wh2_main_agent_action_wizard_hinder_settlement_success_plague_priest_ritual
wh2_main_event_feed_agent_action_champion_hinder_settlement_plague_priest_skaven	wh2_main_agent_action_wizard_hinder_settlement_success_plague_priest_ritual
wh2_main_event_feed_agent_action_champion_hinder_settlement_skaven	wh2_main_agent_action_hinder_settlement_success_assault_garrison
wh2_main_event_feed_agent_action_champion_hinder_settlement_warlock_engineer_dark_elves	wh2_main_agent_action_engineer_hinder_settlement_success_warlock_engineer_ritual
wh2_main_event_feed_agent_action_champion_hinder_settlement_warlock_engineer_high_elves	wh2_main_agent_action_engineer_hinder_settlement_success_warlock_engineer_ritual
wh2_main_event_feed_agent_action_champion_hinder_settlement_warlock_engineer_lizardmen	wh2_main_agent_action_engineer_hinder_settlement_success_warlock_engineer_ritual
wh2_main_event_feed_agent_action_champion_hinder_settlement_warlock_engineer_skaven	wh2_main_agent_action_engineer_hinder_settlement_success_warlock_engineer_ritual
wh2_main_event_feed_agent_action_dignitary_hinder_army_dark_elves	wh2_main_agent_action_hinder_army_success_hinder_replenishment
wh2_main_event_feed_agent_action_dignitary_hinder_army_high_elves	wh2_main_agent_action_hinder_army_success_hinder_replenishment
wh2_main_event_feed_agent_action_dignitary_hinder_army_lizardmen	wh2_main_agent_action_hinder_army_success_hinder_replenishment
wh2_main_event_feed_agent_action_dignitary_hinder_army_skaven	wh2_main_agent_action_hinder_army_success_hinder_replenishment
wh2_main_event_feed_agent_action_dignitary_hinder_settlement_dark_elves	wh2_main_agent_action_hinder_settlement_success_damage_building
wh2_main_event_feed_agent_action_dignitary_hinder_settlement_high_elves	wh2_main_agent_action_hinder_settlement_success_damage_building
wh2_main_event_feed_agent_action_dignitary_hinder_settlement_lizardmen	wh2_main_agent_action_hinder_settlement_success_damage_building
wh2_main_event_feed_agent_action_dignitary_hinder_settlement_skaven	wh2_main_agent_action_hinder_settlement_success_damage_building
wh2_main_event_feed_agent_action_engineer_hinder_settlement_dark_elves	wh2_main_agent_action_hinder_settlement_success_steal_technology
wh2_main_event_feed_agent_action_engineer_hinder_settlement_high_elves	wh2_main_agent_action_hinder_settlement_success_steal_technology
wh2_main_event_feed_agent_action_engineer_hinder_settlement_lizardmen	wh2_main_agent_action_hinder_settlement_success_steal_technology
wh2_main_event_feed_agent_action_engineer_hinder_settlement_skaven	wh2_main_agent_action_hinder_settlement_success_steal_technology
wh2_main_event_feed_agent_action_hinder_settlement_gain_influence_dark_elves	wh2_main_agent_action_hinder_settlement_success_gain_influence
wh2_main_event_feed_agent_action_hinder_settlement_gain_influence_high_elves	wh2_main_agent_action_hinder_settlement_success_gain_influence
wh2_main_event_feed_agent_action_hinder_settlement_gain_influence_lizardmen	wh2_main_agent_action_hinder_settlement_success_gain_influence
wh2_main_event_feed_agent_action_hinder_settlement_gain_influence_skaven	wh2_main_agent_action_hinder_settlement_success_gain_influence
wh2_main_event_feed_agent_action_spy_hinder_army_dark_elves	wh2_main_agent_action_hinder_army_success_block_army
wh2_main_event_feed_agent_action_spy_hinder_army_high_elves	wh2_main_agent_action_hinder_army_success_block_army
wh2_main_event_feed_agent_action_spy_hinder_army_lizardmen	wh2_main_agent_action_hinder_army_success_block_army
wh2_main_event_feed_agent_action_spy_hinder_army_skaven	wh2_main_agent_action_hinder_army_success_block_army
wh2_main_event_feed_agent_action_spy_hinder_settlement_dark_elves	wh2_main_agent_action_hinder_settlement_success_damage_walls
wh2_main_event_feed_agent_action_spy_hinder_settlement_high_elves	wh2_main_agent_action_hinder_settlement_success_damage_walls
wh2_main_event_feed_agent_action_spy_hinder_settlement_lizardmen	wh2_main_agent_action_hinder_settlement_success_damage_walls
wh2_main_event_feed_agent_action_spy_hinder_settlement_skaven	wh2_main_agent_action_hinder_settlement_success_damage_walls
wh2_main_event_feed_agent_action_wizard_hinder_army_dark_elves	wh2_main_agent_action_hinder_army_success_assault_unit
wh2_main_event_feed_agent_action_wizard_hinder_army_high_elves	wh2_main_agent_action_hinder_army_success_assault_unit
wh2_main_event_feed_agent_action_wizard_hinder_army_lizardmen	wh2_main_agent_action_hinder_army_success_assault_unit
wh2_main_event_feed_agent_action_wizard_hinder_army_skaven	wh2_main_agent_action_hinder_army_success_assault_unit
wh3_dlc23_agent_action_daemonsmith_sorcerer_destroy_settlement	wh3_dlc23_agent_action_daemonsmith_sorcerer_destroy_settlement_success_daemonsmith_sorcerer_settlement
wh3_dlc23_event_feed_agent_action_all_failure_critical_hinder_army_chaos_dwarfs	wh_main_agent_action_all_hinder_army_critical_failure
wh3_dlc23_event_feed_agent_action_all_failure_critical_hinder_character_chaos_dwarfs	wh_main_agent_action_all_hinder_character_critical_failure
wh3_dlc23_event_feed_agent_action_all_failure_critical_hinder_province_chaos_dwarfs	wh_main_agent_action_all_hinder_settlement_critical_failure
wh3_dlc23_event_feed_agent_action_all_failure_hinder_army_chaos_dwarfs	wh_main_agent_action_all_hinder_army_failure
wh3_dlc23_event_feed_agent_action_all_failure_hinder_character_chaos_dwarfs	wh_main_agent_action_all_hinder_character_failure
wh3_dlc23_event_feed_agent_action_all_failure_hinder_province_chaos_dwarfs	wh_main_agent_action_all_hinder_settlement_failure
wh3_dlc23_event_feed_agent_action_all_hinder_character_chaos_dwarfs	wh_main_agent_action_all_hinder_agent_success
wh3_dlc23_event_feed_agent_action_all_success_critical_hinder_character_chaos_dwarfs	wh_main_agent_action_all_hinder_agent_critical_success
wh3_dlc23_event_feed_agent_action_champion_hinder_army_chaos_dwarfs	wh2_main_agent_action_hinder_army_success_assault_units
wh3_dlc23_event_feed_agent_action_champion_hinder_settlement_chaos_dwarfs	wh2_main_agent_action_hinder_settlement_success_assault_garrison
wh3_dlc23_event_feed_agent_action_engineer_hinder_army_chaos_dwarfs	wh2_main_agent_action_hinder_army_success_block_army
wh3_dlc23_event_feed_agent_action_engineer_hinder_settlement_chaos_dwarfs	wh2_main_agent_action_hinder_settlement_success_steal_technology
wh3_dlc23_event_feed_agent_action_spy_hinder_army_chaos_dwarfs	wh2_main_agent_action_hinder_army_success_assault_units
wh3_dlc23_event_feed_agent_action_spy_hinder_settlement_chaos_dwarfs	wh2_main_agent_action_hinder_settlement_success_damage_building
wh3_dlc23_event_feed_agent_action_wizard_hinder_army_chaos_dwarfs	wh2_main_agent_action_hinder_army_success_hinder_replenishment
wh3_dlc23_event_feed_agent_action_wizard_hinder_settlement_chaos_dwarfs	wh2_main_agent_action_hinder_settlement_success_steal_technology
wh3_dlc24_event_feed_agent_action_runesmith_hinder_army_kislev	wh3_dlc24_agent_action_hinder_army_success_hags_cursemark
wh3_dlc24_event_feed_agent_action_wizard_hinder_army_chaos	wh3_dlc24_agent_action_hinder_army_success_siphon_winds
wh3_dlc24_event_feed_agent_action_wizard_hinder_army_daemons	wh3_dlc24_agent_action_hinder_army_success_siphon_winds
wh3_dlc24_event_feed_agent_action_wizard_hinder_army_tzeentch	wh3_dlc24_agent_action_hinder_army_success_siphon_winds
wh3_main_event_feed_agent_action_all_failure_critical_hinder_army_cathay	wh_main_agent_action_all_hinder_army_critical_failure
wh3_main_event_feed_agent_action_all_failure_critical_hinder_army_daemons	wh_main_agent_action_all_hinder_army_critical_failure
wh3_main_event_feed_agent_action_all_failure_critical_hinder_army_khorne	wh_main_agent_action_all_hinder_army_critical_failure
wh3_main_event_feed_agent_action_all_failure_critical_hinder_army_kislev	wh_main_agent_action_all_hinder_army_critical_failure
wh3_main_event_feed_agent_action_all_failure_critical_hinder_army_nurgle	wh_main_agent_action_all_hinder_army_critical_failure
wh3_main_event_feed_agent_action_all_failure_critical_hinder_army_ogre_kingdoms	wh_main_agent_action_all_hinder_army_critical_failure
wh3_main_event_feed_agent_action_all_failure_critical_hinder_army_slaanesh	wh_main_agent_action_all_hinder_army_critical_failure
wh3_main_event_feed_agent_action_all_failure_critical_hinder_army_tzeentch	wh_main_agent_action_all_hinder_army_critical_failure
wh3_main_event_feed_agent_action_all_failure_critical_hinder_character_cathay	wh_main_agent_action_all_hinder_character_critical_failure
wh3_main_event_feed_agent_action_all_failure_critical_hinder_character_daemons	wh_main_agent_action_all_hinder_character_critical_failure
wh3_main_event_feed_agent_action_all_failure_critical_hinder_character_khorne	wh_main_agent_action_all_hinder_character_critical_failure
wh3_main_event_feed_agent_action_all_failure_critical_hinder_character_kislev	wh_main_agent_action_all_hinder_character_critical_failure
wh3_main_event_feed_agent_action_all_failure_critical_hinder_character_nurgle	wh_main_agent_action_all_hinder_character_critical_failure
wh3_main_event_feed_agent_action_all_failure_critical_hinder_character_ogre_kingdoms	wh_main_agent_action_all_hinder_character_critical_failure
wh3_main_event_feed_agent_action_all_failure_critical_hinder_character_slaanesh	wh_main_agent_action_all_hinder_character_critical_failure
wh3_main_event_feed_agent_action_all_failure_critical_hinder_character_tzeentch	wh_main_agent_action_all_hinder_character_critical_failure
wh3_main_event_feed_agent_action_all_failure_critical_hinder_province_cathay	wh_main_agent_action_all_hinder_settlement_critical_failure
wh3_main_event_feed_agent_action_all_failure_critical_hinder_province_daemons	wh_main_agent_action_all_hinder_settlement_critical_failure
wh3_main_event_feed_agent_action_all_failure_critical_hinder_province_khorne	wh_main_agent_action_all_hinder_settlement_critical_failure
wh3_main_event_feed_agent_action_all_failure_critical_hinder_province_kislev	wh_main_agent_action_all_hinder_settlement_critical_failure
wh3_main_event_feed_agent_action_all_failure_critical_hinder_province_nurgle	wh_main_agent_action_all_hinder_settlement_critical_failure
wh3_main_event_feed_agent_action_all_failure_critical_hinder_province_ogre_kingdoms	wh_main_agent_action_all_hinder_settlement_critical_failure
wh3_main_event_feed_agent_action_all_failure_critical_hinder_province_slaanesh	wh_main_agent_action_all_hinder_settlement_critical_failure
wh3_main_event_feed_agent_action_all_failure_critical_hinder_province_tzeentch	wh_main_agent_action_all_hinder_settlement_critical_failure
wh3_main_event_feed_agent_action_all_failure_hinder_army_cathay	wh_main_agent_action_all_hinder_army_failure
wh3_main_event_feed_agent_action_all_failure_hinder_army_daemons	wh_main_agent_action_all_hinder_army_failure
wh3_main_event_feed_agent_action_all_failure_hinder_army_khorne	wh_main_agent_action_all_hinder_army_failure
wh3_main_event_feed_agent_action_all_failure_hinder_army_kislev	wh_main_agent_action_all_hinder_army_failure
wh3_main_event_feed_agent_action_all_failure_hinder_army_nurgle	wh_main_agent_action_all_hinder_army_failure
wh3_main_event_feed_agent_action_all_failure_hinder_army_ogre_kingdoms	wh_main_agent_action_all_hinder_army_failure
wh3_main_event_feed_agent_action_all_failure_hinder_army_slaanesh	wh_main_agent_action_all_hinder_army_failure
wh3_main_event_feed_agent_action_all_failure_hinder_army_tzeentch	wh_main_agent_action_all_hinder_army_failure
wh3_main_event_feed_agent_action_all_failure_hinder_character_cathay	wh_main_agent_action_all_hinder_character_failure
wh3_main_event_feed_agent_action_all_failure_hinder_character_daemons	wh_main_agent_action_all_hinder_character_failure
wh3_main_event_feed_agent_action_all_failure_hinder_character_khorne	wh_main_agent_action_all_hinder_character_failure
wh3_main_event_feed_agent_action_all_failure_hinder_character_kislev	wh_main_agent_action_all_hinder_character_failure
wh3_main_event_feed_agent_action_all_failure_hinder_character_nurgle	wh_main_agent_action_all_hinder_character_failure
wh3_main_event_feed_agent_action_all_failure_hinder_character_ogre_kingdoms	wh_main_agent_action_all_hinder_character_failure
wh3_main_event_feed_agent_action_all_failure_hinder_character_slaanesh	wh_main_agent_action_all_hinder_character_failure
wh3_main_event_feed_agent_action_all_failure_hinder_character_tzeentch	wh_main_agent_action_all_hinder_character_failure
wh3_main_event_feed_agent_action_all_failure_hinder_province_cathay	wh_main_agent_action_all_hinder_settlement_failure
wh3_main_event_feed_agent_action_all_failure_hinder_province_daemons	wh_main_agent_action_all_hinder_settlement_failure
wh3_main_event_feed_agent_action_all_failure_hinder_province_khorne	wh_main_agent_action_all_hinder_settlement_failure
wh3_main_event_feed_agent_action_all_failure_hinder_province_kislev	wh_main_agent_action_all_hinder_settlement_failure
wh3_main_event_feed_agent_action_all_failure_hinder_province_nurgle	wh_main_agent_action_all_hinder_settlement_failure
wh3_main_event_feed_agent_action_all_failure_hinder_province_ogre_kingdoms	wh_main_agent_action_all_hinder_settlement_failure
wh3_main_event_feed_agent_action_all_failure_hinder_province_slaanesh	wh_main_agent_action_all_hinder_settlement_failure
wh3_main_event_feed_agent_action_all_failure_hinder_province_tzeentch	wh_main_agent_action_all_hinder_settlement_failure
wh3_main_event_feed_agent_action_all_hinder_character_cathay	wh_main_agent_action_all_hinder_agent_success
wh3_main_event_feed_agent_action_all_hinder_character_daemons	wh_main_agent_action_all_hinder_agent_success
wh3_main_event_feed_agent_action_all_hinder_character_khorne	wh_main_agent_action_all_hinder_agent_success
wh3_main_event_feed_agent_action_all_hinder_character_kislev	wh_main_agent_action_all_hinder_agent_success
wh3_main_event_feed_agent_action_all_hinder_character_nurgle	wh_main_agent_action_all_hinder_agent_success
wh3_main_event_feed_agent_action_all_hinder_character_ogre_kingdoms	wh_main_agent_action_all_hinder_agent_success
wh3_main_event_feed_agent_action_all_hinder_character_slaanesh	wh_main_agent_action_all_hinder_agent_success
wh3_main_event_feed_agent_action_all_hinder_character_tzeentch	wh_main_agent_action_all_hinder_agent_success
wh3_main_event_feed_agent_action_all_success_critical_hinder_character_cathay	wh_main_agent_action_all_hinder_agent_critical_success
wh3_main_event_feed_agent_action_all_success_critical_hinder_character_daemons	wh_main_agent_action_all_hinder_agent_critical_success
wh3_main_event_feed_agent_action_all_success_critical_hinder_character_khorne	wh_main_agent_action_all_hinder_agent_critical_success
wh3_main_event_feed_agent_action_all_success_critical_hinder_character_kislev	wh_main_agent_action_all_hinder_agent_critical_success
wh3_main_event_feed_agent_action_all_success_critical_hinder_character_nurgle	wh_main_agent_action_all_hinder_agent_critical_success
wh3_main_event_feed_agent_action_all_success_critical_hinder_character_ogre_kingdoms	wh_main_agent_action_all_hinder_agent_critical_success
wh3_main_event_feed_agent_action_all_success_critical_hinder_character_slaanesh	wh_main_agent_action_all_hinder_agent_critical_success
wh3_main_event_feed_agent_action_all_success_critical_hinder_character_tzeentch	wh_main_agent_action_all_hinder_agent_critical_success
wh3_main_event_feed_agent_action_champion_hinder_army_cathay	wh2_main_agent_action_hinder_army_success_assault_units
wh3_main_event_feed_agent_action_champion_hinder_army_daemons	wh2_main_agent_action_hinder_army_success_assault_units
wh3_main_event_feed_agent_action_champion_hinder_army_khorne	wh2_main_agent_action_hinder_army_success_assault_units
wh3_main_event_feed_agent_action_champion_hinder_army_kislev	wh2_main_agent_action_hinder_army_success_assault_units
wh3_main_event_feed_agent_action_champion_hinder_army_nurgle	wh2_main_agent_action_hinder_army_success_assault_units
wh3_main_event_feed_agent_action_champion_hinder_army_ogre_kingdoms	wh2_main_agent_action_hinder_army_success_assault_units
wh3_main_event_feed_agent_action_champion_hinder_army_slaanesh	wh2_main_agent_action_hinder_army_success_assault_units
wh3_main_event_feed_agent_action_champion_hinder_army_tzeentch	wh2_main_agent_action_hinder_army_success_assault_units
wh3_main_event_feed_agent_action_champion_hinder_settlement_cathay	wh2_main_agent_action_hinder_settlement_success_assault_garrison
wh3_main_event_feed_agent_action_champion_hinder_settlement_daemons	wh2_main_agent_action_hinder_settlement_success_assault_garrison
wh3_main_event_feed_agent_action_champion_hinder_settlement_khorne	wh2_main_agent_action_hinder_settlement_success_assault_garrison
wh3_main_event_feed_agent_action_champion_hinder_settlement_kislev	wh2_main_agent_action_hinder_settlement_success_assault_garrison
wh3_main_event_feed_agent_action_champion_hinder_settlement_nurgle	wh2_main_agent_action_hinder_settlement_success_assault_garrison
wh3_main_event_feed_agent_action_champion_hinder_settlement_ogre_kingdoms	wh2_main_agent_action_hinder_settlement_success_assault_garrison
wh3_main_event_feed_agent_action_champion_hinder_settlement_plague_priest_cathay	wh2_main_agent_action_wizard_hinder_settlement_success_plague_priest_ritual
wh3_main_event_feed_agent_action_champion_hinder_settlement_plague_priest_daemons	wh2_main_agent_action_wizard_hinder_settlement_success_plague_priest_ritual
wh3_main_event_feed_agent_action_champion_hinder_settlement_plague_priest_khorne	wh2_main_agent_action_wizard_hinder_settlement_success_plague_priest_ritual
wh3_main_event_feed_agent_action_champion_hinder_settlement_plague_priest_kislev	wh2_main_agent_action_wizard_hinder_settlement_success_plague_priest_ritual
wh3_main_event_feed_agent_action_champion_hinder_settlement_plague_priest_nurgle	wh2_main_agent_action_wizard_hinder_settlement_success_plague_priest_ritual
wh3_main_event_feed_agent_action_champion_hinder_settlement_plague_priest_ogre_kingdoms	wh2_main_agent_action_wizard_hinder_settlement_success_plague_priest_ritual
wh3_main_event_feed_agent_action_champion_hinder_settlement_plague_priest_slaanesh	wh2_main_agent_action_wizard_hinder_settlement_success_plague_priest_ritual
wh3_main_event_feed_agent_action_champion_hinder_settlement_plague_priest_tzeentch	wh2_main_agent_action_wizard_hinder_settlement_success_plague_priest_ritual
wh3_main_event_feed_agent_action_champion_hinder_settlement_slaanesh	wh2_main_agent_action_hinder_settlement_success_assault_garrison
wh3_main_event_feed_agent_action_champion_hinder_settlement_tzeentch	wh2_main_agent_action_hinder_settlement_success_assault_garrison
wh3_main_event_feed_agent_action_champion_hinder_settlement_warlock_engineer_cathay	wh2_main_agent_action_engineer_hinder_settlement_success_warlock_engineer_ritual
wh3_main_event_feed_agent_action_champion_hinder_settlement_warlock_engineer_daemons	wh2_main_agent_action_engineer_hinder_settlement_success_warlock_engineer_ritual
wh3_main_event_feed_agent_action_champion_hinder_settlement_warlock_engineer_khorne	wh2_main_agent_action_engineer_hinder_settlement_success_warlock_engineer_ritual
wh3_main_event_feed_agent_action_champion_hinder_settlement_warlock_engineer_kislev	wh2_main_agent_action_engineer_hinder_settlement_success_warlock_engineer_ritual
wh3_main_event_feed_agent_action_champion_hinder_settlement_warlock_engineer_nurgle	wh2_main_agent_action_engineer_hinder_settlement_success_warlock_engineer_ritual
wh3_main_event_feed_agent_action_champion_hinder_settlement_warlock_engineer_ogre_kingdoms	wh2_main_agent_action_engineer_hinder_settlement_success_warlock_engineer_ritual
wh3_main_event_feed_agent_action_champion_hinder_settlement_warlock_engineer_slaanesh	wh2_main_agent_action_engineer_hinder_settlement_success_warlock_engineer_ritual
wh3_main_event_feed_agent_action_champion_hinder_settlement_warlock_engineer_tzeentch	wh2_main_agent_action_engineer_hinder_settlement_success_warlock_engineer_ritual
wh3_main_event_feed_agent_action_dignitary_hinder_army_cathay	wh2_main_agent_action_hinder_army_success_hinder_replenishment
wh3_main_event_feed_agent_action_dignitary_hinder_army_daemons	wh2_main_agent_action_hinder_army_success_hinder_replenishment
wh3_main_event_feed_agent_action_dignitary_hinder_army_khorne	wh2_main_agent_action_hinder_army_success_hinder_replenishment
wh3_main_event_feed_agent_action_dignitary_hinder_army_kislev	wh2_main_agent_action_hinder_army_success_hinder_replenishment
wh3_main_event_feed_agent_action_dignitary_hinder_army_nurgle	wh2_main_agent_action_hinder_army_success_hinder_replenishment
wh3_main_event_feed_agent_action_dignitary_hinder_army_ogre_kingdoms	wh2_main_agent_action_hinder_army_success_hinder_replenishment
wh3_main_event_feed_agent_action_dignitary_hinder_army_slaanesh	wh2_main_agent_action_hinder_army_success_hinder_replenishment
wh3_main_event_feed_agent_action_dignitary_hinder_army_tzeentch	wh2_main_agent_action_hinder_army_success_hinder_replenishment
wh3_main_event_feed_agent_action_dignitary_hinder_settlement_cathay	wh2_main_agent_action_hinder_settlement_success_damage_building
wh3_main_event_feed_agent_action_dignitary_hinder_settlement_daemons	wh2_main_agent_action_hinder_settlement_success_damage_building
wh3_main_event_feed_agent_action_dignitary_hinder_settlement_khorne	wh2_main_agent_action_hinder_settlement_success_damage_building
wh3_main_event_feed_agent_action_dignitary_hinder_settlement_kislev	wh2_main_agent_action_hinder_settlement_success_damage_building
wh3_main_event_feed_agent_action_dignitary_hinder_settlement_nurgle	wh2_main_agent_action_hinder_settlement_success_damage_building
wh3_main_event_feed_agent_action_dignitary_hinder_settlement_ogre_kingdoms	wh2_main_agent_action_hinder_settlement_success_damage_building
wh3_main_event_feed_agent_action_dignitary_hinder_settlement_slaanesh	wh2_main_agent_action_hinder_settlement_success_damage_building
wh3_main_event_feed_agent_action_dignitary_hinder_settlement_tzeentch	wh2_main_agent_action_hinder_settlement_success_damage_building
wh3_main_event_feed_agent_action_engineer_hinder_settlement_cathay	wh2_main_agent_action_hinder_settlement_success_steal_technology
wh3_main_event_feed_agent_action_engineer_hinder_settlement_daemons	wh2_main_agent_action_hinder_settlement_success_steal_technology
wh3_main_event_feed_agent_action_engineer_hinder_settlement_khorne	wh2_main_agent_action_hinder_settlement_success_steal_technology
wh3_main_event_feed_agent_action_engineer_hinder_settlement_kislev	wh2_main_agent_action_hinder_settlement_success_steal_technology
wh3_main_event_feed_agent_action_engineer_hinder_settlement_nurgle	wh2_main_agent_action_hinder_settlement_success_steal_technology
wh3_main_event_feed_agent_action_engineer_hinder_settlement_ogre_kingdoms	wh2_main_agent_action_hinder_settlement_success_steal_technology
wh3_main_event_feed_agent_action_engineer_hinder_settlement_slaanesh	wh2_main_agent_action_hinder_settlement_success_steal_technology
wh3_main_event_feed_agent_action_engineer_hinder_settlement_tzeentch	wh2_main_agent_action_hinder_settlement_success_steal_technology
wh3_main_event_feed_agent_action_hinder_army_plague_cultist_ritual	wh3_main_agent_action_all_hinder_army_sucess_plague_cultist_ritual
wh3_main_event_feed_agent_action_hinder_settlement_establish_cult_khorne	wh3_main_agent_action_hinder_settlement_success_establish_cult
wh3_main_event_feed_agent_action_hinder_settlement_establish_cult_magus_khorne	wh3_main_agent_action_hinder_settlement_success_establish_cult_magus
wh3_main_event_feed_agent_action_hinder_settlement_establish_cult_magus_nurgle	wh3_main_agent_action_hinder_settlement_success_establish_cult_magus
wh3_main_event_feed_agent_action_hinder_settlement_establish_cult_magus_slaanesh	wh3_main_agent_action_hinder_settlement_success_establish_cult_magus
wh3_main_event_feed_agent_action_hinder_settlement_establish_cult_magus_tzeentch	wh3_main_agent_action_hinder_settlement_success_establish_cult_magus
wh3_main_event_feed_agent_action_hinder_settlement_establish_cult_nurgle	wh3_main_agent_action_hinder_settlement_success_establish_cult
wh3_main_event_feed_agent_action_hinder_settlement_establish_cult_slaanesh	wh3_main_agent_action_hinder_settlement_success_establish_cult
wh3_main_event_feed_agent_action_hinder_settlement_establish_cult_tzeentch	wh3_main_agent_action_hinder_settlement_success_establish_cult
wh3_main_event_feed_agent_action_hinder_settlement_gain_influence_cathay	wh2_main_agent_action_hinder_settlement_success_gain_influence
wh3_main_event_feed_agent_action_hinder_settlement_gain_influence_daemons	wh2_main_agent_action_hinder_settlement_success_gain_influence
wh3_main_event_feed_agent_action_hinder_settlement_gain_influence_khorne	wh2_main_agent_action_hinder_settlement_success_gain_influence
wh3_main_event_feed_agent_action_hinder_settlement_gain_influence_kislev	wh2_main_agent_action_hinder_settlement_success_gain_influence
wh3_main_event_feed_agent_action_hinder_settlement_gain_influence_nurgle	wh2_main_agent_action_hinder_settlement_success_gain_influence
wh3_main_event_feed_agent_action_hinder_settlement_gain_influence_ogre_kingdoms	wh2_main_agent_action_hinder_settlement_success_gain_influence
wh3_main_event_feed_agent_action_hinder_settlement_gain_influence_slaanesh	wh2_main_agent_action_hinder_settlement_success_gain_influence
wh3_main_event_feed_agent_action_hinder_settlement_gain_influence_tzeentch	wh2_main_agent_action_hinder_settlement_success_gain_influence
wh3_main_event_feed_agent_action_hinder_settlement_plague_cultist_ritual	wh3_main_agent_action_all_hinder_settlement_sucess_plague_cultist_ritual
wh3_main_event_feed_agent_action_spy_hinder_army_cathay	wh2_main_agent_action_hinder_army_success_block_army
wh3_main_event_feed_agent_action_spy_hinder_army_daemons	wh2_main_agent_action_hinder_army_success_block_army
wh3_main_event_feed_agent_action_spy_hinder_army_khorne	wh2_main_agent_action_hinder_army_success_block_army
wh3_main_event_feed_agent_action_spy_hinder_army_kislev	wh2_main_agent_action_hinder_army_success_block_army
wh3_main_event_feed_agent_action_spy_hinder_army_nurgle	wh2_main_agent_action_hinder_army_success_block_army
wh3_main_event_feed_agent_action_spy_hinder_army_ogre_kingdoms	wh2_main_agent_action_hinder_army_success_block_army
wh3_main_event_feed_agent_action_spy_hinder_army_slaanesh	wh2_main_agent_action_hinder_army_success_block_army
wh3_main_event_feed_agent_action_spy_hinder_army_tzeentch	wh2_main_agent_action_hinder_army_success_block_army
wh3_main_event_feed_agent_action_spy_hinder_settlement_cathay	wh2_main_agent_action_hinder_settlement_success_damage_walls
wh3_main_event_feed_agent_action_spy_hinder_settlement_daemons	wh2_main_agent_action_hinder_settlement_success_damage_walls
wh3_main_event_feed_agent_action_spy_hinder_settlement_khorne	wh2_main_agent_action_hinder_settlement_success_damage_walls
wh3_main_event_feed_agent_action_spy_hinder_settlement_kislev	wh2_main_agent_action_hinder_settlement_success_damage_walls
wh3_main_event_feed_agent_action_spy_hinder_settlement_nurgle	wh2_main_agent_action_hinder_settlement_success_damage_walls
wh3_main_event_feed_agent_action_spy_hinder_settlement_ogre_kingdoms	wh2_main_agent_action_hinder_settlement_success_damage_walls
wh3_main_event_feed_agent_action_spy_hinder_settlement_slaanesh	wh2_main_agent_action_hinder_settlement_success_damage_walls
wh3_main_event_feed_agent_action_spy_hinder_settlement_tzeentch	wh2_main_agent_action_hinder_settlement_success_damage_walls
wh3_main_event_feed_agent_action_wizard_hinder_army_cathay	wh2_main_agent_action_hinder_army_success_assault_unit
wh3_main_event_feed_agent_action_wizard_hinder_army_daemons	wh2_main_agent_action_hinder_army_success_assault_unit
wh3_main_event_feed_agent_action_wizard_hinder_army_khorne	wh2_main_agent_action_hinder_army_success_assault_unit
wh3_main_event_feed_agent_action_wizard_hinder_army_kislev	wh2_main_agent_action_hinder_army_success_assault_unit
wh3_main_event_feed_agent_action_wizard_hinder_army_nurgle	wh2_main_agent_action_hinder_army_success_assault_unit
wh3_main_event_feed_agent_action_wizard_hinder_army_ogre_kingdoms	wh2_main_agent_action_hinder_army_success_assault_unit
wh3_main_event_feed_agent_action_wizard_hinder_army_slaanesh	wh2_main_agent_action_hinder_army_success_assault_unit
wh3_main_event_feed_agent_action_wizard_hinder_army_tzeentch	wh2_main_agent_action_hinder_army_success_assault_unit
wh3_main_pro_event_feed_agent_action_all_failure_critical_hinder_army_kislev	wh_main_agent_action_all_hinder_army_critical_failure
wh3_main_pro_event_feed_agent_action_all_failure_critical_hinder_character_kislev	wh_main_agent_action_all_hinder_character_critical_failure
wh3_main_pro_event_feed_agent_action_all_failure_critical_hinder_province_kislev	wh_main_agent_action_all_hinder_settlement_critical_failure
wh3_main_pro_event_feed_agent_action_all_failure_hinder_army_kislev	wh_main_agent_action_all_hinder_army_failure
wh3_main_pro_event_feed_agent_action_all_failure_hinder_character_kislev	wh_main_agent_action_all_hinder_character_failure
wh3_main_pro_event_feed_agent_action_all_failure_hinder_province_kislev	wh_main_agent_action_all_hinder_settlement_failure
wh3_main_pro_event_feed_agent_action_all_hinder_character_kislev	wh_main_agent_action_all_hinder_agent_success
wh3_main_pro_event_feed_agent_action_all_success_critical_hinder_character_kislev	wh_main_agent_action_all_hinder_agent_critical_success
wh3_main_pro_event_feed_agent_action_champion_hinder_army_kislev	wh2_main_agent_action_hinder_army_success_assault_units
wh3_main_pro_event_feed_agent_action_champion_hinder_settlement_kislev	wh2_main_agent_action_hinder_settlement_success_assault_garrison
wh3_main_pro_event_feed_agent_action_champion_hinder_settlement_plague_priest_kislev	wh2_main_agent_action_wizard_hinder_settlement_success_plague_priest_ritual
wh3_main_pro_event_feed_agent_action_champion_hinder_settlement_warlock_engineer_kislev	wh2_main_agent_action_engineer_hinder_settlement_success_warlock_engineer_ritual
wh3_main_pro_event_feed_agent_action_dignitary_hinder_army_kislev	wh2_main_agent_action_hinder_army_success_hinder_replenishment
wh3_main_pro_event_feed_agent_action_dignitary_hinder_settlement_kislev	wh2_main_agent_action_hinder_settlement_success_damage_building
wh3_main_pro_event_feed_agent_action_engineer_hinder_settlement_kislev	wh2_main_agent_action_hinder_settlement_success_steal_technology
wh3_main_pro_event_feed_agent_action_hinder_settlement_gain_influence_kislev	wh2_main_agent_action_hinder_settlement_success_gain_influence
wh3_main_pro_event_feed_agent_action_spy_hinder_army_kislev	wh2_main_agent_action_hinder_army_success_block_army
wh3_main_pro_event_feed_agent_action_spy_hinder_settlement_kislev	wh2_main_agent_action_hinder_settlement_success_damage_walls
wh3_main_pro_event_feed_agent_action_wizard_hinder_army_kislev	wh2_main_agent_action_hinder_army_success_assault_unit
wh_dlc03_event_feed_agent_action_all_failure_critical_hinder_army_beastmen	wh_main_agent_action_all_hinder_army_critical_failure
wh_dlc03_event_feed_agent_action_all_failure_critical_hinder_character_beastmen	wh_main_agent_action_all_hinder_character_critical_failure
wh_dlc03_event_feed_agent_action_all_failure_critical_hinder_province_beastmen	wh_main_agent_action_all_hinder_settlement_critical_failure
wh_dlc03_event_feed_agent_action_all_failure_hinder_army_beastmen	wh_main_agent_action_all_hinder_army_failure
wh_dlc03_event_feed_agent_action_all_failure_hinder_character_beastmen	wh_main_agent_action_all_hinder_character_failure
wh_dlc03_event_feed_agent_action_all_failure_hinder_province_beastmen	wh_main_agent_action_all_hinder_settlement_failure
wh_dlc03_event_feed_agent_action_all_hinder_character_beastmen	wh_main_agent_action_all_hinder_agent_success
wh_dlc03_event_feed_agent_action_all_success_critical_hinder_character_beastmen	wh_main_agent_action_all_hinder_agent_critical_success
wh_dlc03_event_feed_agent_action_champion_hinder_army_beastmen	wh2_main_agent_action_hinder_army_success_assault_units
wh_dlc03_event_feed_agent_action_champion_hinder_settlement_beastmen	wh2_main_agent_action_hinder_settlement_success_assault_garrison
wh_dlc03_event_feed_agent_action_champion_hinder_settlement_plague_priest_beastmen	wh2_main_agent_action_wizard_hinder_settlement_success_plague_priest_ritual
wh_dlc03_event_feed_agent_action_champion_hinder_settlement_warlock_engineer_beastmen	wh2_main_agent_action_engineer_hinder_settlement_success_warlock_engineer_ritual
wh_dlc03_event_feed_agent_action_dignitary_hinder_army_beastmen	wh2_main_agent_action_hinder_army_success_hinder_replenishment
wh_dlc03_event_feed_agent_action_dignitary_hinder_settlement_beastmen	wh2_main_agent_action_hinder_settlement_success_damage_building
wh_dlc03_event_feed_agent_action_engineer_hinder_settlement_beastmen	wh2_main_agent_action_hinder_settlement_success_steal_technology
wh_dlc03_event_feed_agent_action_hinder_settlement_gain_influence_beastmen	wh2_main_agent_action_hinder_settlement_success_gain_influence
wh_dlc03_event_feed_agent_action_spy_hinder_army_beastmen	wh2_main_agent_action_hinder_army_success_block_army
wh_dlc03_event_feed_agent_action_spy_hinder_settlement_beastmen	wh2_main_agent_action_hinder_settlement_success_damage_walls
wh_dlc03_event_feed_agent_action_wizard_hinder_army_beastmen	wh2_main_agent_action_hinder_army_success_assault_unit
wh_dlc05_event_feed_agent_action_all_failure_critical_hinder_army_wood_elves	wh_main_agent_action_all_hinder_army_critical_failure
wh_dlc05_event_feed_agent_action_all_failure_critical_hinder_character_wood_elves	wh_main_agent_action_all_hinder_character_critical_failure
wh_dlc05_event_feed_agent_action_all_failure_critical_hinder_province_wood_elves	wh_main_agent_action_all_hinder_settlement_critical_failure
wh_dlc05_event_feed_agent_action_all_failure_hinder_army_wood_elves	wh_main_agent_action_all_hinder_army_failure
wh_dlc05_event_feed_agent_action_all_failure_hinder_character_wood_elves	wh_main_agent_action_all_hinder_character_failure
wh_dlc05_event_feed_agent_action_all_failure_hinder_province_wood_elves	wh_main_agent_action_all_hinder_settlement_failure
wh_dlc05_event_feed_agent_action_all_hinder_character_wood_elves	wh_main_agent_action_all_hinder_agent_success
wh_dlc05_event_feed_agent_action_all_success_critical_hinder_character_wood_elves	wh_main_agent_action_all_hinder_agent_critical_success
wh_dlc05_event_feed_agent_action_champion_hinder_army_wood_elves	wh2_main_agent_action_hinder_army_success_assault_units
wh_dlc05_event_feed_agent_action_champion_hinder_settlement_plague_priest_wood_elves	wh2_main_agent_action_wizard_hinder_settlement_success_plague_priest_ritual
wh_dlc05_event_feed_agent_action_champion_hinder_settlement_warlock_engineer_wood_elves	wh2_main_agent_action_engineer_hinder_settlement_success_warlock_engineer_ritual
wh_dlc05_event_feed_agent_action_champion_hinder_settlement_wood_elves	wh2_main_agent_action_hinder_settlement_success_assault_garrison
wh_dlc05_event_feed_agent_action_dignitary_hinder_army_wood_elves	wh2_main_agent_action_hinder_army_success_hinder_replenishment
wh_dlc05_event_feed_agent_action_dignitary_hinder_settlement_wood_elves	wh2_main_agent_action_hinder_settlement_success_damage_building
wh_dlc05_event_feed_agent_action_engineer_hinder_settlement_wood_elves	wh2_main_agent_action_hinder_settlement_success_steal_technology
wh_dlc05_event_feed_agent_action_hinder_settlement_gain_influence_wood_elves	wh2_main_agent_action_hinder_settlement_success_gain_influence
wh_dlc05_event_feed_agent_action_spy_hinder_army_wood_elves	wh2_main_agent_action_hinder_army_success_block_army
wh_dlc05_event_feed_agent_action_spy_hinder_settlement_wood_elves	wh2_main_agent_action_hinder_settlement_success_damage_walls
wh_dlc05_event_feed_agent_action_wizard_hinder_army_wood_elves	wh2_main_agent_action_hinder_army_success_assault_unit
wh_dlc07_event_feed_agent_action_champion_hinder_settlement_plague_priest_bretonnia	wh2_main_agent_action_wizard_hinder_settlement_success_plague_priest_ritual
wh_dlc07_event_feed_agent_action_champion_hinder_settlement_warlock_engineer_bretonnia	wh2_main_agent_action_engineer_hinder_settlement_success_warlock_engineer_ritual
wh_dlc07_feed_agent_action_all_failure_critical_hinder_army_bretonnia	wh_main_agent_action_all_hinder_army_critical_failure
wh_dlc07_feed_agent_action_all_failure_critical_hinder_character_bretonnia	wh_main_agent_action_all_hinder_character_critical_failure
wh_dlc07_feed_agent_action_all_failure_critical_hinder_province_bretonnia	wh_main_agent_action_all_hinder_settlement_critical_failure
wh_dlc07_feed_agent_action_all_failure_hinder_army_bretonnia	wh_main_agent_action_all_hinder_army_failure
wh_dlc07_feed_agent_action_all_failure_hinder_character_bretonnia	wh_main_agent_action_all_hinder_character_failure
wh_dlc07_feed_agent_action_all_failure_hinder_province_bretonnia	wh_main_agent_action_all_hinder_settlement_failure
wh_dlc07_feed_agent_action_all_hinder_character_bretonnia	wh_main_agent_action_all_hinder_agent_success
wh_dlc07_feed_agent_action_all_success_critical_hinder_character_bretonnia	wh_main_agent_action_all_hinder_agent_critical_success
wh_dlc07_feed_agent_action_champion_hinder_army_bretonnia	wh2_main_agent_action_hinder_army_success_assault_units
wh_dlc07_feed_agent_action_champion_hinder_settlement_bretonnia	wh2_main_agent_action_hinder_settlement_success_assault_garrison
wh_dlc07_feed_agent_action_dignitary_hinder_army_bretonnia	wh2_main_agent_action_hinder_army_success_hinder_replenishment
wh_dlc07_feed_agent_action_dignitary_hinder_settlement_bretonnia	wh2_main_agent_action_hinder_settlement_success_damage_building
wh_dlc07_feed_agent_action_engineer_hinder_settlement_bretonnia	wh2_main_agent_action_hinder_settlement_success_steal_technology
wh_dlc07_feed_agent_action_hinder_settlement_gain_influence_bretonnia	wh2_main_agent_action_hinder_settlement_success_gain_influence
wh_dlc07_feed_agent_action_spy_hinder_army_bretonnia	wh2_main_agent_action_hinder_army_success_block_army
wh_dlc07_feed_agent_action_spy_hinder_settlement_bretonnia	wh2_main_agent_action_hinder_settlement_success_damage_walls
wh_dlc07_feed_agent_action_wizard_hinder_army_bretonnia	wh2_main_agent_action_hinder_army_success_assault_unit
wh_dlc10_feed_agent_action_shadow_walker_hinder_character_bretonnia	wh2_dlc10_agent_action_shadow_walker_hinder_agent_success
wh_dlc10_feed_agent_action_shadow_walker_hinder_character_cathay	wh2_dlc10_agent_action_shadow_walker_hinder_agent_success
wh_dlc10_feed_agent_action_shadow_walker_hinder_character_chaos	wh2_dlc10_agent_action_shadow_walker_hinder_agent_success
wh_dlc10_feed_agent_action_shadow_walker_hinder_character_chaos_dwarfs	wh2_dlc10_agent_action_shadow_walker_hinder_agent_success
wh_dlc10_feed_agent_action_shadow_walker_hinder_character_daemons	wh2_dlc10_agent_action_shadow_walker_hinder_agent_success
wh_dlc10_feed_agent_action_shadow_walker_hinder_character_dark_elves	wh2_dlc10_agent_action_shadow_walker_hinder_agent_success
wh_dlc10_feed_agent_action_shadow_walker_hinder_character_dwarfs	wh2_dlc10_agent_action_shadow_walker_hinder_agent_success
wh_dlc10_feed_agent_action_shadow_walker_hinder_character_empire	wh2_dlc10_agent_action_shadow_walker_hinder_agent_success
wh_dlc10_feed_agent_action_shadow_walker_hinder_character_greenskins	wh2_dlc10_agent_action_shadow_walker_hinder_agent_success
wh_dlc10_feed_agent_action_shadow_walker_hinder_character_high_elves	wh2_dlc10_agent_action_shadow_walker_hinder_agent_success
wh_dlc10_feed_agent_action_shadow_walker_hinder_character_khorne	wh2_dlc10_agent_action_shadow_walker_hinder_agent_success
wh_dlc10_feed_agent_action_shadow_walker_hinder_character_kislev	wh2_dlc10_agent_action_shadow_walker_hinder_agent_success
wh_dlc10_feed_agent_action_shadow_walker_hinder_character_lizardmen	wh2_dlc10_agent_action_shadow_walker_hinder_agent_success
wh_dlc10_feed_agent_action_shadow_walker_hinder_character_norsca	wh2_dlc10_agent_action_shadow_walker_hinder_agent_success
wh_dlc10_feed_agent_action_shadow_walker_hinder_character_nurgle	wh2_dlc10_agent_action_shadow_walker_hinder_agent_success
wh_dlc10_feed_agent_action_shadow_walker_hinder_character_ogre_kingdoms	wh2_dlc10_agent_action_shadow_walker_hinder_agent_success
wh_dlc10_feed_agent_action_shadow_walker_hinder_character_skaven	wh2_dlc10_agent_action_shadow_walker_hinder_agent_success
wh_dlc10_feed_agent_action_shadow_walker_hinder_character_slaanesh	wh2_dlc10_agent_action_shadow_walker_hinder_agent_success
wh_dlc10_feed_agent_action_shadow_walker_hinder_character_tomb_kings	wh2_dlc10_agent_action_shadow_walker_hinder_agent_success
wh_dlc10_feed_agent_action_shadow_walker_hinder_character_tzeentch	wh2_dlc10_agent_action_shadow_walker_hinder_agent_success
wh_dlc10_feed_agent_action_shadow_walker_hinder_character_vampire_counts	wh2_dlc10_agent_action_shadow_walker_hinder_agent_success
wh_dlc10_feed_agent_action_shadow_walker_hinder_character_wood_elves	wh2_dlc10_agent_action_shadow_walker_hinder_agent_success
wh_event_feed_agent_action_all_failure_critical_hinder_army_chaos	wh_main_agent_action_all_hinder_army_critical_failure
wh_event_feed_agent_action_all_failure_critical_hinder_army_dwarfs	wh_main_agent_action_all_hinder_army_critical_failure
wh_event_feed_agent_action_all_failure_critical_hinder_army_empire	wh_main_agent_action_all_hinder_army_critical_failure
wh_event_feed_agent_action_all_failure_critical_hinder_army_greenskins	wh_main_agent_action_all_hinder_army_critical_failure
wh_event_feed_agent_action_all_failure_critical_hinder_army_norsca	wh_main_agent_action_all_hinder_army_critical_failure
wh_event_feed_agent_action_all_failure_critical_hinder_army_vampire_counts	wh_main_agent_action_all_hinder_army_critical_failure
wh_event_feed_agent_action_all_failure_critical_hinder_character_chaos	wh_main_agent_action_all_hinder_character_critical_failure
wh_event_feed_agent_action_all_failure_critical_hinder_character_dwarfs	wh_main_agent_action_all_hinder_character_critical_failure
wh_event_feed_agent_action_all_failure_critical_hinder_character_empire	wh_main_agent_action_all_hinder_character_critical_failure
wh_event_feed_agent_action_all_failure_critical_hinder_character_greenskins	wh_main_agent_action_all_hinder_character_critical_failure
wh_event_feed_agent_action_all_failure_critical_hinder_character_norsca	wh_main_agent_action_all_hinder_character_critical_failure
wh_event_feed_agent_action_all_failure_critical_hinder_character_vampire_counts	wh_main_agent_action_all_hinder_character_critical_failure
wh_event_feed_agent_action_all_failure_critical_hinder_province_chaos	wh_main_agent_action_all_hinder_settlement_critical_failure
wh_event_feed_agent_action_all_failure_critical_hinder_province_dwarfs	wh_main_agent_action_all_hinder_settlement_critical_failure
wh_event_feed_agent_action_all_failure_critical_hinder_province_empire	wh_main_agent_action_all_hinder_settlement_critical_failure
wh_event_feed_agent_action_all_failure_critical_hinder_province_greenskins	wh_main_agent_action_all_hinder_settlement_critical_failure
wh_event_feed_agent_action_all_failure_critical_hinder_province_norsca	wh_main_agent_action_all_hinder_settlement_critical_failure
wh_event_feed_agent_action_all_failure_critical_hinder_province_vampire_counts	wh_main_agent_action_all_hinder_settlement_critical_failure
wh_event_feed_agent_action_all_failure_hinder_army_chaos	wh_main_agent_action_all_hinder_army_failure
wh_event_feed_agent_action_all_failure_hinder_army_dwarfs	wh_main_agent_action_all_hinder_army_failure
wh_event_feed_agent_action_all_failure_hinder_army_empire	wh_main_agent_action_all_hinder_army_failure
wh_event_feed_agent_action_all_failure_hinder_army_greenskins	wh_main_agent_action_all_hinder_army_failure
wh_event_feed_agent_action_all_failure_hinder_army_norsca	wh_main_agent_action_all_hinder_army_failure
wh_event_feed_agent_action_all_failure_hinder_army_vampire_counts	wh_main_agent_action_all_hinder_army_failure
wh_event_feed_agent_action_all_failure_hinder_character_chaos	wh_main_agent_action_all_hinder_character_failure
wh_event_feed_agent_action_all_failure_hinder_character_dwarfs	wh_main_agent_action_all_hinder_character_failure
wh_event_feed_agent_action_all_failure_hinder_character_empire	wh_main_agent_action_all_hinder_character_failure
wh_event_feed_agent_action_all_failure_hinder_character_greenskins	wh_main_agent_action_all_hinder_character_failure
wh_event_feed_agent_action_all_failure_hinder_character_norsca	wh_main_agent_action_all_hinder_character_failure
wh_event_feed_agent_action_all_failure_hinder_character_vampire_counts	wh_main_agent_action_all_hinder_character_failure
wh_event_feed_agent_action_all_failure_hinder_province_chaos	wh_main_agent_action_all_hinder_settlement_failure
wh_event_feed_agent_action_all_failure_hinder_province_dwarfs	wh_main_agent_action_all_hinder_settlement_failure
wh_event_feed_agent_action_all_failure_hinder_province_empire	wh_main_agent_action_all_hinder_settlement_failure
wh_event_feed_agent_action_all_failure_hinder_province_greenskins	wh_main_agent_action_all_hinder_settlement_failure
wh_event_feed_agent_action_all_failure_hinder_province_norsca	wh_main_agent_action_all_hinder_settlement_failure
wh_event_feed_agent_action_all_failure_hinder_province_vampire_counts	wh_main_agent_action_all_hinder_settlement_failure
wh_event_feed_agent_action_all_hinder_character_chaos	wh_main_agent_action_all_hinder_agent_success
wh_event_feed_agent_action_all_hinder_character_dwarfs	wh_main_agent_action_all_hinder_agent_success
wh_event_feed_agent_action_all_hinder_character_empire	wh_main_agent_action_all_hinder_agent_success
wh_event_feed_agent_action_all_hinder_character_greenskins	wh_main_agent_action_all_hinder_agent_success
wh_event_feed_agent_action_all_hinder_character_norsca	wh_main_agent_action_all_hinder_agent_success
wh_event_feed_agent_action_all_hinder_character_vampire_counts	wh_main_agent_action_all_hinder_agent_success
wh_event_feed_agent_action_all_success_critical_hinder_character_chaos	wh_main_agent_action_all_hinder_agent_critical_success
wh_event_feed_agent_action_all_success_critical_hinder_character_dwarfs	wh_main_agent_action_all_hinder_agent_critical_success
wh_event_feed_agent_action_all_success_critical_hinder_character_empire	wh_main_agent_action_all_hinder_agent_critical_success
wh_event_feed_agent_action_all_success_critical_hinder_character_greenskins	wh_main_agent_action_all_hinder_agent_critical_success
wh_event_feed_agent_action_all_success_critical_hinder_character_norsca	wh_main_agent_action_all_hinder_agent_critical_success
wh_event_feed_agent_action_all_success_critical_hinder_character_vampire_counts	wh_main_agent_action_all_hinder_agent_critical_success
wh_event_feed_agent_action_champion_hinder_army_chaos	wh2_main_agent_action_hinder_army_success_assault_units
wh_event_feed_agent_action_champion_hinder_army_dwarfs	wh2_main_agent_action_hinder_army_success_assault_units
wh_event_feed_agent_action_champion_hinder_army_empire	wh2_main_agent_action_hinder_army_success_assault_units
wh_event_feed_agent_action_champion_hinder_army_greenskins	wh2_main_agent_action_hinder_army_success_assault_units
wh_event_feed_agent_action_champion_hinder_army_norsca	wh2_main_agent_action_hinder_army_success_assault_units
wh_event_feed_agent_action_champion_hinder_army_vampire_counts	wh2_main_agent_action_hinder_army_success_assault_units
wh_event_feed_agent_action_champion_hinder_settlement_chaos	wh2_main_agent_action_hinder_settlement_success_assault_garrison
wh_event_feed_agent_action_champion_hinder_settlement_dwarfs	wh2_main_agent_action_hinder_settlement_success_assault_garrison
wh_event_feed_agent_action_champion_hinder_settlement_empire	wh2_main_agent_action_hinder_settlement_success_assault_garrison
wh_event_feed_agent_action_champion_hinder_settlement_greenskins	wh2_main_agent_action_hinder_settlement_success_assault_garrison
wh_event_feed_agent_action_champion_hinder_settlement_norsca	wh2_main_agent_action_hinder_settlement_success_assault_garrison
wh_event_feed_agent_action_champion_hinder_settlement_plague_priest_chaos	wh2_main_agent_action_wizard_hinder_settlement_success_plague_priest_ritual
wh_event_feed_agent_action_champion_hinder_settlement_plague_priest_dwarfs	wh2_main_agent_action_wizard_hinder_settlement_success_plague_priest_ritual
wh_event_feed_agent_action_champion_hinder_settlement_plague_priest_empire	wh2_main_agent_action_wizard_hinder_settlement_success_plague_priest_ritual
wh_event_feed_agent_action_champion_hinder_settlement_plague_priest_greenskins	wh2_main_agent_action_wizard_hinder_settlement_success_plague_priest_ritual
wh_event_feed_agent_action_champion_hinder_settlement_plague_priest_norsca	wh2_main_agent_action_wizard_hinder_settlement_success_plague_priest_ritual
wh_event_feed_agent_action_champion_hinder_settlement_plague_priest_vampire_counts	wh2_main_agent_action_wizard_hinder_settlement_success_plague_priest_ritual
wh_event_feed_agent_action_champion_hinder_settlement_vampire_counts	wh2_main_agent_action_hinder_settlement_success_assault_garrison
wh_event_feed_agent_action_champion_hinder_settlement_warlock_engineer_chaos	wh2_main_agent_action_engineer_hinder_settlement_success_warlock_engineer_ritual
wh_event_feed_agent_action_champion_hinder_settlement_warlock_engineer_dwarfs	wh2_main_agent_action_engineer_hinder_settlement_success_warlock_engineer_ritual
wh_event_feed_agent_action_champion_hinder_settlement_warlock_engineer_empire	wh2_main_agent_action_engineer_hinder_settlement_success_warlock_engineer_ritual
wh_event_feed_agent_action_champion_hinder_settlement_warlock_engineer_greenskins	wh2_main_agent_action_engineer_hinder_settlement_success_warlock_engineer_ritual
wh_event_feed_agent_action_champion_hinder_settlement_warlock_engineer_norsca	wh2_main_agent_action_engineer_hinder_settlement_success_warlock_engineer_ritual
wh_event_feed_agent_action_champion_hinder_settlement_warlock_engineer_vampire_counts	wh2_main_agent_action_engineer_hinder_settlement_success_warlock_engineer_ritual
wh_event_feed_agent_action_dignitary_hinder_army_chaos	wh2_main_agent_action_hinder_army_success_hinder_replenishment
wh_event_feed_agent_action_dignitary_hinder_army_dwarfs	wh2_main_agent_action_hinder_army_success_hinder_replenishment
wh_event_feed_agent_action_dignitary_hinder_army_empire	wh2_main_agent_action_hinder_army_success_hinder_replenishment
wh_event_feed_agent_action_dignitary_hinder_army_greenskins	wh2_main_agent_action_hinder_army_success_hinder_replenishment
wh_event_feed_agent_action_dignitary_hinder_army_norsca	wh2_main_agent_action_hinder_army_success_hinder_replenishment
wh_event_feed_agent_action_dignitary_hinder_army_vampire_counts	wh2_main_agent_action_hinder_army_success_hinder_replenishment
wh_event_feed_agent_action_dignitary_hinder_settlement_chaos	wh2_main_agent_action_hinder_settlement_success_damage_building
wh_event_feed_agent_action_dignitary_hinder_settlement_dwarfs	wh2_main_agent_action_hinder_settlement_success_damage_building
wh_event_feed_agent_action_dignitary_hinder_settlement_empire	wh2_main_agent_action_hinder_settlement_success_damage_building
wh_event_feed_agent_action_dignitary_hinder_settlement_greenskins	wh2_main_agent_action_hinder_settlement_success_damage_building
wh_event_feed_agent_action_dignitary_hinder_settlement_norsca	wh2_main_agent_action_hinder_settlement_success_damage_building
wh_event_feed_agent_action_dignitary_hinder_settlement_vampire_counts	wh2_main_agent_action_hinder_settlement_success_damage_building
wh_event_feed_agent_action_engineer_hinder_settlement_chaos	wh2_main_agent_action_hinder_settlement_success_steal_technology
wh_event_feed_agent_action_engineer_hinder_settlement_dwarfs	wh2_main_agent_action_hinder_settlement_success_steal_technology
wh_event_feed_agent_action_engineer_hinder_settlement_empire	wh2_main_agent_action_hinder_settlement_success_steal_technology
wh_event_feed_agent_action_engineer_hinder_settlement_greenskins	wh2_main_agent_action_hinder_settlement_success_steal_technology
wh_event_feed_agent_action_engineer_hinder_settlement_norsca	wh2_main_agent_action_hinder_settlement_success_steal_technology
wh_event_feed_agent_action_engineer_hinder_settlement_vampire_counts	wh2_main_agent_action_hinder_settlement_success_steal_technology
wh_event_feed_agent_action_hinder_settlement_gain_influence_chaos	wh2_main_agent_action_hinder_settlement_success_gain_influence
wh_event_feed_agent_action_hinder_settlement_gain_influence_dwarfs	wh2_main_agent_action_hinder_settlement_success_gain_influence
wh_event_feed_agent_action_hinder_settlement_gain_influence_empire	wh2_main_agent_action_hinder_settlement_success_gain_influence
wh_event_feed_agent_action_hinder_settlement_gain_influence_greenskins	wh2_main_agent_action_hinder_settlement_success_gain_influence
wh_event_feed_agent_action_hinder_settlement_gain_influence_norsca	wh2_main_agent_action_hinder_settlement_success_gain_influence
wh_event_feed_agent_action_hinder_settlement_gain_influence_vampire_counts	wh2_main_agent_action_hinder_settlement_success_gain_influence
wh_event_feed_agent_action_spy_hinder_army_chaos	wh2_main_agent_action_hinder_army_success_block_army
wh_event_feed_agent_action_spy_hinder_army_dwarfs	wh2_main_agent_action_hinder_army_success_block_army
wh_event_feed_agent_action_spy_hinder_army_empire	wh2_main_agent_action_hinder_army_success_block_army
wh_event_feed_agent_action_spy_hinder_army_greenskins	wh2_main_agent_action_hinder_army_success_block_army
wh_event_feed_agent_action_spy_hinder_army_norsca	wh2_main_agent_action_hinder_army_success_block_army
wh_event_feed_agent_action_spy_hinder_army_vampire_counts	wh2_main_agent_action_hinder_army_success_block_army
wh_event_feed_agent_action_spy_hinder_settlement_chaos	wh2_main_agent_action_hinder_settlement_success_damage_walls
wh_event_feed_agent_action_spy_hinder_settlement_dwarfs	wh2_main_agent_action_hinder_settlement_success_damage_walls
wh_event_feed_agent_action_spy_hinder_settlement_empire	wh2_main_agent_action_hinder_settlement_success_damage_walls
wh_event_feed_agent_action_spy_hinder_settlement_greenskins	wh2_main_agent_action_hinder_settlement_success_damage_walls
wh_event_feed_agent_action_spy_hinder_settlement_norsca	wh2_main_agent_action_hinder_settlement_success_damage_walls
wh_event_feed_agent_action_spy_hinder_settlement_vampire_counts	wh2_main_agent_action_hinder_settlement_success_damage_walls
wh_event_feed_agent_action_wizard_hinder_army_chaos	wh2_main_agent_action_hinder_army_success_assault_unit
wh_event_feed_agent_action_wizard_hinder_army_dwarfs	wh2_main_agent_action_hinder_army_success_assault_unit
wh_event_feed_agent_action_wizard_hinder_army_empire	wh2_main_agent_action_hinder_army_success_assault_unit
wh_event_feed_agent_action_wizard_hinder_army_greenskins	wh2_main_agent_action_hinder_army_success_assault_unit
wh_event_feed_agent_action_wizard_hinder_army_norsca	wh2_main_agent_action_hinder_army_success_assault_unit
wh_event_feed_agent_action_wizard_hinder_army_vampire_counts	wh2_main_agent_action_hinder_army_success_assault_unit
