key	unit_ability	unit_set
#unit_set_unit_ability_junctions_tables;0;db/unit_set_unit_ability_junctions_tables/data__		
:wh3_dlc25_effect_ability_enable_dig_in_for_engineers	wh3_dlc23_unit_passive_dig_in	dwf_master_engineer
ancient_treemen_wrath_of_the_wood	wh2_dlc16_lore_passive_wrath_of_the_wood	wh2_dlc16_wef_ancient_treemen
arcane_conduit_chd_lammasu	wh_main_character_abilities_arcane_conduit	wh3_dlc23_chd_lammasu
awe_inspiring_sight_dwf_spirit_of_grungni	wh3_dlc25_unit_passive_awe_inspiring_sight	dwf_spirit_of_grungni_summon
ballistics_callibration_chd_missile_inf	wh_main_hero_abilities_ballistics_calibration	wh3_dlc23_chd_category_chaos_dwarf_missile_infantry
blazing_body_chd_warmachines	wh3_dlc23_unit_passive_blazing_body	wh3_dlc23_chd_category_warmachines
bloodgreed_chd_centaur_taurus	wh_dlc03_unit_passive_bloodgreed	wh3_dlc23_chd_category_bull_centaurs
bloodgreed_chd_kdaai	wh_dlc03_unit_passive_bloodgreed	wh3_dlc23_chd_category_kdaai
bloodgreed_chd_skullcracker	wh_dlc03_unit_passive_bloodgreed	wh3_dlc23_chd_skullcracker
bloodgreed_khorne_units	wh_dlc03_unit_passive_bloodgreed	wh3_dlc20_chs_khorne_marked_units
burning_bright_chd_kdaai	wh3_dlc23_unit_passive_burning_bright	wh3_dlc23_chd_category_kdaai
burning_bright_upgraded_chd_kdaai	wh3_dlc23_unit_passive_burning_bright_upgraded	wh3_dlc23_chd_category_kdaai
daemonic_rebirth_kdaai_fireborn	wh3_dlc23_unit_passive_daemonic_rebirth	wh3_dlc23_chd_kdaai_fireborn
daring_deathblow_doomseekers	wh_dlc08_lord_passive_daring_deathblow	dwf_doomseekers
deathblow_chd_infernal_guard	wh_main_unit_passive_deathblow	wh3_dlc23_chd_infernal_guard_infernal_ironsword
deathblow_doomseekers	wh_main_unit_passive_deathblow	dwf_doomseekers
deathblow_slayers	wh_main_unit_passive_deathblow	dwf_slayers
determined_deathblow_doomseekers	wh_dlc08_lord_passive_determined_deathblow	dwf_doomseekers
determined_deathblow_slayers	wh_dlc08_lord_passive_determined_deathblow	dwf_slayers
dig_in_chd_missile_inf	wh3_dlc23_unit_passive_dig_in	wh3_dlc23_chd_category_chaos_dwarf_missile_infantry
dig_in_dwf_flame_cannons	wh3_dlc23_unit_passive_dig_in	dwf_flame_cannon
dig_in_dwf_irondrakes	wh3_dlc23_unit_passive_dig_in	dwf_irondrakes
dig_in_dwf_organ_guns	wh3_dlc23_unit_passive_dig_in	dwf_organ_guns
dlc08_nor_marauders_champions_guardian	wh2_dlc09_unit_passive_guardian	dlc08_nor_marauders_champions
emergency_repairs_dwf_gyros	wh3_dlc25_unit_passive_emergency_repairs	dwf_gyros
emergency_repairs_dwf_thunderbarge	wh3_dlc25_unit_passive_emergency_repairs	dwf_thunderbarge
emp_black_rose_knights_iron_resolve	wh3_dlc25_unit_passive_iron_resolve	emp_black_rose_knights
emp_gelt_golden_globe	wh3_main_cataclysm_metal_gehennas_golden_globe	emp_gelt
emp_steam_tank_more_power	wh3_dlc23_unit_abilities_more_power	emp_steam_tank
emp_steam_tank_repair	wh3_dlc25_unit_passive_emergency_repairs	emp_steam_tank
enrage_chd_flying_beasts	wh_pro04_unit_abilities_enrage	wh3_dlc23_chd_category_flying_beasts
entrenchment_chd_missile_inf	wh_main_unit_abilities_entrenchment	wh3_dlc23_chd_category_chaos_dwarf_missile_infantry
extra_powder_chd_missile_inf	wh2_dlc11_unit_passive_extra_powder	wh3_dlc23_chd_category_chaos_dwarf_missile_infantry
extra_powder_chd_warmachines_arty	wh2_dlc11_unit_passive_extra_powder	wh3_dlc23_chd_category_warmachines
extra_reload_chd_missile_inf	wh3_dlc23_unit_passive_extra_reload	wh3_dlc23_chd_category_chaos_dwarf_missile_infantry
extra_reload_chd_warmachines_arty	wh3_dlc23_unit_passive_extra_reload	wh3_dlc23_chd_category_warmachines
fire_bomb_gyrobomber	wh3_dlc25_unit_abilities_gyrobomber_fire_bomb	dwf_gyrobombers_no_ror
flaming_breath_chd_bale_taurus	wh3_dlc23_unit_abilities_flaming_breath	wh3_dlc23_chd_bale_taurus
flaming_breath_chd_great_taurus	wh3_dlc23_unit_abilities_flaming_breath	wh3_dlc23_chd_great_taurus
forgefire_chd_kdaai	wh_main_hero_passive_forgefire	wh3_dlc23_chd_category_kdaai
forgefire_chd_warmachines	wh_main_hero_passive_forgefire	wh3_dlc23_chd_category_warmachines
frenzy_chd_centaurs_taurus	wh_main_unit_passive_frenzy	wh3_dlc23_chd_category_bull_centaurs
frenzy_chd_flying_monsters	wh_main_unit_passive_frenzy	wh3_dlc23_chd_category_flying_beasts
frenzy_chd_hobgoblins	wh_main_unit_passive_frenzy	wh3_dlc23_chd_hobgoblin_units
frenzy_chd_lammasu	wh_main_unit_passive_frenzy	wh3_dlc23_chd_lammasu
frenzy_chd_melee_inf	wh_main_unit_passive_frenzy	wh3_dlc23_chd_category_chaos_dwarf_melee_infantry
frenzy_clanrats_stormvermin	wh_main_unit_passive_frenzy	skv_stormvermin_clanrats
frenzy_dwf_hammerers	wh_main_unit_passive_frenzy	dwf_hammerers_rank_7
frenzy_dwf_longbeards	wh_main_unit_passive_frenzy	dwf_longbeards
frenzy_dwf_slayers	wh_main_unit_passive_frenzy	dwf_slayers
gaze_of_fate_tzeentch_characters	wh3_main_lord_abilities_gaze_of_fate	tzeentch_characters
glittering_scales_chd_melee_inf	wh_main_weapon_passive_glittering_scales	wh3_dlc23_chd_category_chaos_dwarf_melee_infantry
greater_arcane_conduit_chd_lammasu	wh2_main_character_passive_grand_arcane_conduit	wh3_dlc23_chd_lammasu_rank7
guardian_greatswords	wh2_dlc09_unit_passive_guardian	emp_greatswords
guardian_reiksguard	wh2_dlc09_unit_passive_guardian	emp_reiksguard
gun_cav_restock	wh3_dlc25_abilities_restock_gunnery_school	wh3_dlc25_gunnery_cavalry
gyrobomber_bomb_gyrobomber	wh_main_unit_abilities_gyrobomber_bomb	dwf_gyrobombers_no_ror
hellbound_chd_warmachines_arty	wh3_dlc23_unit_passive_hellbound	wh3_dlc23_chd_category_warmachines
hungering_blades_chd_centaur	wh3_twa06_unit_passive_hungering_blades	wh3_dlc23_chd_category_bull_centaurs
hungering_blades_chd_kdaai_destroyer	wh3_twa06_unit_passive_hungering_blades	wh3_dlc23_chd_kdaai_destroyer
hungering_blades_chd_melee_inf	wh3_twa06_unit_passive_hungering_blades	wh3_dlc23_chd_category_chaos_dwarf_melee_infantry
hungering_blades_chd_warmachines_arty	wh3_twa06_unit_passive_hungering_blades	wh3_dlc23_chd_category_warmachines
murderous_charge_chd_bull_centaur	wh3_dlc20_unit_passive_murderous_charge	wh3_dlc23_chd_category_bull_centaurs
murderous_charge_chd_flying_beasts	wh3_dlc20_unit_passive_murderous_charge	wh3_dlc23_chd_category_flying_beasts
murderous_charge_chd_kdaai	wh3_dlc20_unit_passive_murderous_charge	wh3_dlc23_chd_category_kdaai
murderous_charge_chd_warmachines	wh3_dlc20_unit_passive_murderous_charge	wh3_dlc23_chd_category_warmachines
portalglyph_undivided_characters	wh3_main_item_abilities_the_portalglyph	undivided_characters
primal_fury_upgraded	wh2_dlc17_unit_passive_primal_fury_upgraded	bst_primal_fury_units
rage_chd_melee_inf	wh_dlc08_unit_passive_rage	wh3_dlc23_chd_category_chaos_dwarf_melee_infantry
regeneration_nurgle_units	wh_main_unit_passive_regeneration	wh3_dlc20_chs_nurgle_marked_units
shield_wall_dwf_warriors_longbeards	wh3_dlc25_unit_formation_shieldwall	dwf_shield_warriors_longbeards
shield_wall_upgraded_dwf_ironbreaker	wh3_dlc25_unit_formation_shieldwall_upgraded	dwf_ironbreaker
shield_wall_upgraded_dwf_ironbreaker_rank_7	wh3_dlc25_unit_formation_shieldwall_upgraded	dwf_ironbreaker_rank_7
shield_wall_upgraded_dwf_ironbreaker_ror_rank_7	wh3_dlc25_unit_formation_shieldwall_upgraded	dwf_ironbreaker_ror_rank_7
skyhammer_bomb	wh_dlc06_unit_abilities_skyhammer_bomb	dwf_skyhammer_gyrobomber_only
skyhammer_fire_bomb	wh_dlc06_unit_abilities_skyhammer_fire_bomb	dwf_skyhammer_gyrobomber_only
sonic_boom_slaanesh_characters	wh3_main_daemon_head_abilities_sonic_boom	slaanesh_characters
spirit_of_grungni_summon_unbinding	wh3_dlc25_unit_passive_unbinding_spirit_of_grungni	dwf_spirit_of_grungni_summon
spirit_of_grungni_summon_unbinding_upgraded	wh3_dlc25_unit_passive_unbinding_spirit_of_grungni_upgraded	dwf_spirit_of_grungni_summon
spirit_of_grungni_summon_unbinding_upgraded_2	wh3_dlc25_unit_passive_unbinding_spirit_of_grungni_upgraded_2	dwf_spirit_of_grungni_summon
strength_from_flesh_chd_bull_centaurs	wh2_dlc17_unit_passive_strength_from_flesh	wh3_dlc23_chd_category_bull_centaurs
strength_from_flesh_chd_flying_beasts	wh2_dlc17_unit_passive_strength_from_flesh	wh3_dlc23_chd_category_flying_beasts
thorek_mounted_greater_locus_of_power	wh2_dlc17_lord_passive_greater_locus_of_power	thorek_mounted
thorek_mounted_locus_of_power	wh_dlc06_lord_passive_locus_of_power	thorek_mounted
thunderburner_dwf_spirit_of_grungni	wh3_dlc25_unit_abilities_thunderburner	dwf_spirit_of_grungni_summon
thunderburner_upgraded_dwf_spirit_of_grungni	wh3_dlc25_unit_abilities_thunderburner_upgraded	dwf_spirit_of_grungni_summon
treekin_resplendence_of_luminescents	wh2_dlc16_character_passive_resplendence_of_luminescents	wh_dlc05_wef_mon_treekin
treemen_annoyance_of_netlings	wh2_dlc16_character_passive_annoyance_of_netlings	wef_dlc05_treemen
treemen_murder_of_spites	wh2_dlc16_character_passive_murder_of_spites	wh2_dlc16_wef_mon_malicious_treeman_0
trophy_heads_khorne_characters	wh3_main_daemon_wings_abilities_trophy_heads	khorne_characters
virulent_contagion_upgraded_nurgle_characters	wh3_main_lord_abilities_virulent_contagion_upgraded	nurgle_characters
wayfarer_helblasters	wh2_dlc17_unit_passive_wayfarer	wh3_dlc25_helblasters
wh2_dlc09_effect_ability_deathblow_for_skeleton_units	wh_main_unit_passive_deathblow	wh2_dlc09_tmb_all_skeleton
wh2_dlc09_effect_ability_frenzy_to_ushabti_units	wh_main_unit_passive_frenzy	wh2_dlc09_tmb_ushabti
wh2_dlc09_effect_ability_hawkish_precision_to_archer_units	wh_dlc05_hero_passive_hawkish_precision	wh2_dlc09_tmb_all_archer_units
wh2_dlc10_effect_ability_hawkish_precision_to_archer_units	wh_dlc05_hero_passive_hawkish_precision	wh2_dlc10_hef_all_ranged
wh2_dlc11_cst_cha_vampire_fleet_captain_garrison_1	wh_main_spell_vampires_invocation_of_nehek	wh2_dlc11_cst_cha_vampire_fleet_captain_0
wh2_dlc11_cst_cha_vampire_fleet_captain_garrison_2	wh_main_spell_vampires_vanhels_danse_macabre	wh2_dlc11_cst_cha_vampire_fleet_captain_0
wh2_dlc11_effect_ability_the_ravenous_dead_for_zombie_units	wh2_dlc11_unit_passive_the_ravenous_dead	vmp_zombies
wh2_dlc12_lord_passive_warpstone_detonation	wh2_dlc12_lord_passive_warpstone_detonation	wh2_dlc12_skv_cha_doomflayer
wh2_dlc12_lzd_tiktaqto_enable_terradon_drop_rocks_0	wh2_dlc12_unit_abilities_drop_rocks_of_sundering	lzd_terradon_riders_0
wh2_dlc12_lzd_tiktaqto_enable_terradon_drop_rocks_0_ror_uses_mod	wh2_dlc12_unit_abilities_drop_rocks_of_sundering	wh2_dlc12_lzd_cav_terradon_riders_ror_0
wh2_dlc12_lzd_tiktaqto_enable_terradon_drop_rocks_1	wh2_dlc12_unit_abilities_drop_rocks_of_chotec	lzd_terradon_riders_1
wh2_dlc12_passive_enable_skaven_doomflayer_blade_swirl	wh2_dlc12_unit_passive_blade_swirl	wh2_dlc12_skv_doomflayers
wh2_dlc12_skaven_ratling_passive_ability_endless_drum	wh2_dlc12_unit_passive_endless_drum	wh2_dlc12_skv_ratling
wh2_dlc12_skv_ikit_claw_storm_daemon	wh2_dlc12_weapon_abilities_storm_daemon	wh2_dlc12_skv_ikit_claw
wh2_dlc12_skv_jezzail_hawkish_precision	wh_dlc05_hero_passive_hawkish_precision	wh2_dlc12_skv_jezzail
wh2_dlc12_skv_passive_enable_doomflayer_character_overload	wh2_dlc12_lord_passive_overload	wh2_dlc12_skv_cha_doomflayer
wh2_dlc13_ability_enable_frenzy_kroxigors	wh_main_unit_passive_frenzy	lzd_kroxigor
wh2_dlc13_ability_enable_refuse_to_die_saurus	wh2_dlc12_unit_abilities_refuse_to_die	lzd_saurus
wh2_dlc13_final_battle_character_abilities_rodrik_ward_save_reduction	wh2_dlc13_final_battle_character_abilities_rodrik_ward_save_reduction	mp_cap_hero_rodrik
wh2_dlc13_hunter_final_battle_effect_jorek_dummy	wh2_dlc13_final_battle_character_abilities_jorek_ammo_replenishment	mp_cap_hero_jorek
wh2_dlc14_def_malus_tzarkan	wh2_dlc14_lord_abilities_tzarkan	wh2_dlc14_def_malus_darkblade_foot
wh2_dlc14_def_malus_tzarkan_spite	wh2_dlc14_lord_abilities_tzarkan_spite	wh2_dlc14_def_malus_darkblade_spite
wh2_dlc14_enable_ability_gutterrunners	wh2_main_unit_abilities_concealment_bombs	skv_gutterrunners
wh2_dlc14_enable_ability_nightrunners	wh2_main_unit_abilities_concealment_bombs	skv_nightrunners
wh2_dlc14_lord_abilities_tzarkan	wh2_dlc14_lord_abilities_tzarkan	wh2_dlc14_def_cha_malus
wh2_dlc14_lord_abilities_tzarkan_spite	wh2_dlc14_lord_abilities_tzarkan_spite	wh2_dlc14_def_cha_malus
wh2_dlc14_skv_snikch_tzarkan	wh2_dlc14_lord_abilities_tzarkan_snikch	wh2_dlc14_skv_snikch
wh2_dlc14_skv_warp_grinder_regeneration	wh_main_unit_passive_regeneration	wh2_dlc14_skv_warp_grinder
wh2_dlc14_skv_warp_grinder_witness_me	wh2_dlc12_unit_passive_witness_me	wh2_dlc14_skv_warp_grinder
wh2_dlc15_ability_enable_frenzy_all_boyz_and_big_uns	wh_main_unit_passive_frenzy	wh2_dlc15_grn_all_boyz_and_big_uns
wh2_dlc15_berserk_non_savage_orc_infantry	wh_dlc08_unit_passive_berserk	wh2_dlc11_grn_all_orc_infantry
wh2_dlc15_berserk_savage_orc_infantry	wh_dlc08_unit_passive_berserk	grn_dlc06_savage_orc_infantry
wh2_dlc15_effect_ability_disable_hef_passives_1	wh2_main_unit_passive_martial_mastery	wh2_dlc15_hef_martial_passives
wh2_dlc15_effect_ability_disable_hef_passives_2	wh2_main_unit_passive_martial_prowess	wh2_dlc15_hef_martial_passives
wh2_dlc15_effect_ability_enable_grim_discipline	wh2_dlc15_unit_passive_grim_discipline	wh2_dlc15_hef_martial_passives
wh2_dlc15_effect_ability_enable_mimic_berserk	wh2_dlc15_unit_passive_mimic_berserk	wh2_dlc15_mistwalkers
wh2_dlc15_effect_ability_enable_mimic_blessing_of_the_lady	wh2_dlc15_unit_passive_mimic_the_blessing_of_the_lady	wh2_dlc15_mistwalkers
wh2_dlc15_effect_ability_enable_mimic_bloodgreed	wh2_dlc15_unit_passive_mimic_bloodgreed	wh2_dlc15_mistwalkers
wh2_dlc15_effect_ability_enable_mimic_cold_blooded	wh2_dlc15_unit_abilities_mimic_cold_blooded	wh2_dlc15_mistwalkers
wh2_dlc15_effect_ability_enable_mimic_ethereal	wh2_dlc15_unit_passive_mimic_ethereal	wh2_dlc15_mistwalkers
wh2_dlc15_effect_ability_enable_mimic_extra_powder	wh2_dlc15_unit_passive_mimic_extra_powder	wh2_dlc15_mistwalkers
wh2_dlc15_effect_ability_enable_mimic_feint_and_riposte	wh2_dlc15_unit_abilities_mimic_feint_and_riposte	wh2_dlc15_mistwalkers
wh2_dlc15_effect_ability_enable_mimic_forest_walker	wh2_dlc15_unit_passive_mimic_forest_walker	wh2_dlc15_mistwalkers
wh2_dlc15_effect_ability_enable_mimic_grand_hammer_of_faith	wh2_dlc15_unit_abilities_mimic_grand_hammer_of_faith	wh2_dlc15_mistwalkers
wh2_dlc15_effect_ability_enable_mimic_grom_waaagh	wh2_dlc15_unit_abilities_mimic_grom_waaagh	wh2_dlc15_mistwalkers
wh2_dlc15_effect_ability_enable_mimic_liquid_fortification	wh2_dlc15_unit_passive_mimic_liquid_fortification	wh2_dlc15_mistwalkers
wh2_dlc15_effect_ability_enable_mimic_loecs_shroud	wh2_dlc15_unit_abilities_mimic_loecs_shroud	wh2_dlc15_mistwalkers
wh2_dlc15_effect_ability_enable_mimic_murderous_prowess	wh2_dlc15_unit_abilities_mimic_murderous_prowess	wh2_dlc15_mistwalkers
wh2_dlc15_effect_ability_enable_mimic_primal_fury	wh2_dlc15_unit_passive_mimic_primal_fury	wh2_dlc15_mistwalkers
wh2_dlc15_effect_ability_enable_mimic_realm_of_souls_1	wh2_dlc15_unit_passive_mimic_realm_of_souls_1	wh2_dlc15_mistwalkers
wh2_dlc15_effect_ability_enable_mimic_realm_of_souls_2	wh2_dlc15_unit_passive_mimic_realm_of_souls_2	wh2_dlc15_mistwalkers
wh2_dlc15_effect_ability_enable_mimic_realm_of_souls_3	wh2_dlc15_unit_passive_mimic_realm_of_souls_3	wh2_dlc15_mistwalkers
wh2_dlc15_effect_ability_enable_mimic_ruinshelter	wh2_dlc15_unit_abilities_mimic_ruinshelter	wh2_dlc15_mistwalkers
wh2_dlc15_effect_ability_enable_mimic_scurry_away	wh2_dlc15_unit_passive_mimic_scurry_away	wh2_dlc15_mistwalkers
wh2_dlc15_effect_ability_enable_mimic_strength_in_numbers	wh2_dlc15_unit_passive_mimic_strength_in_numbers	wh2_dlc15_mistwalkers
wh2_dlc15_effect_ability_enable_mimic_waaagh	wh2_dlc15_unit_abilities_mimic_waaagh	wh2_dlc15_mistwalkers
wh2_dlc15_effect_ability_enable_unending_volley_1	wh2_dlc15_unit_abilities_unending_volley	missile_units
wh2_dlc15_frenzy_goblin_inf	wh_main_unit_passive_frenzy	grn_infantry_goblin
wh2_dlc15_grn_regeneration_goblin	wh_main_unit_passive_regeneration	grn_infantry_goblin
wh2_dlc15_regeneration_tree_spirits	wh_main_unit_passive_regeneration	wef_dlc05_trees
wh2_dlc15_spiky_skin_goblin_inf	wh2_dlc15_unit_passive_spiky_skin	grn_infantry_goblin
wh2_dlc15_unit_ability_ghostly_protection_idol	wh2_dlc15_unit_passive_ghostly_protection	wh2_dlc15_grn_mon_rogue_idol
wh2_dlc15_unit_ability_ignore_pain_trolls_giants	wh2_dlc15_unit_passive_ignore_pain	wh2_dlc15_grn_mon_trolls_giants
wh2_dlc15_unit_ability_immense_power_idol	wh2_dlc15_unit_passive_immense_power	wh2_dlc15_grn_mon_rogue_idol
wh2_dlc15_unit_ability_immense_power_idol_ror	wh2_dlc15_unit_passive_immense_power	wh2_dlc15_grn_mon_rogue_idol_ror
wh2_dlc15_unit_ability_journeys_end_slayers	wh2_dlc15_unit_passive_journeys_end	dwf_slayers
wh2_dlc15_unit_ability_maternal_instincts_arachnarok	wh_dlc06_unit_abilities_maternal_instinct	grn_arachnarok
wh2_dlc15_unit_ability_monstrous_disease_troll_giant	wh2_dlc15_unit_passive_monstrous_disease	wh2_dlc15_grn_mon_trolls_giants
wh2_dlc16_bound_flock_of_doom_ancient_treemen	wh_dlc08_spell_bound_flock_of_doom	wh2_dlc16_wef_ancient_treemen
wh2_dlc16_curse_of_anraheir_sisters_of_the_thorn	wh_dlc05_spell_bound_the_curse_of_anraheir	wef_dlc05_wood_elf_sisters_thorn
wh2_dlc16_deathblow_tree_spirits	wh_main_unit_passive_deathblow	wh2_dlc16_malevolent_trees
wh2_dlc16_effect_ability_enable_berserk_hidden	wh_dlc08_unit_passive_berserk	wh2_dlc16_chs_marauders_rank7
wh2_dlc16_effect_ability_enable_improved_scurry_away	wh2_dlc16_unit_passive_scurry_away_improved	wh2_dlc16_skv_scurry_away
wh2_dlc16_effect_ability_enable_rage_marauders_sigvald	wh_dlc08_unit_passive_rage	chs_marauders
wh2_dlc16_effect_ability_enable_unending_volley_character	wh2_dlc15_unit_abilities_unending_volley	characters
wh2_dlc16_frenzy_drycha_monsters	wh_main_unit_passive_frenzy	wh2_dlc16_drycha_monstermash
wh2_dlc16_glamour_lvl2_wef_elf_characters	wh2_dlc16_unit_passive_glamoured_lvl2	wef_dlc05_elf_characters
wh2_dlc16_glamour_lvl2_wef_elves	wh2_dlc16_unit_passive_glamoured_lvl2	wef_dlc05_wood_elf_elf_units
wh2_dlc16_glamour_wef_elf_characters	wh2_dlc16_unit_passive_glamoured	wef_dlc05_elf_characters
wh2_dlc16_glamour_wef_elves	wh2_dlc16_unit_passive_glamoured	wef_dlc05_wood_elf_elf_units
wh2_dlc16_guardian_for_orion	wh2_dlc09_unit_passive_guardian	wef_orion
wh2_dlc16_madness_of_khaine_wardancers_blade_singers	wh2_dlc16_unit_passive_madness_of_khaine	wef_dlc05_wardancers
wh2_dlc16_poison_attacks_tree_spirits_not_dryad_ror	wh2_dlc16_unit_passive_yewberry_infusion	wef_dlc05_trees_not_dryad_ror
wh2_dlc16_shield_of_thorns_sisters_of_the_thorn	wh_dlc05_spell_bound_shield_of_thorns	wef_dlc05_wood_elf_sisters_thorn
wh2_dlc16_spell_bound_vampires_lesser_raise_dead	wh2_dlc16_spell_bound_vampires_lesser_raise_dead	vmp_dlc04_corpse_carts_mortis_engine
wh2_dlc16_wef_annoyance_of_netlings_dryads_ror	wh2_dlc16_character_passive_annoyance_of_netlings	wh2_dlc16_wef_dryad_ror
wh2_dlc16_wef_annoyance_of_netlings_rank_7_dryads	wh2_dlc16_character_passive_annoyance_of_netlings	wh2_dlc16_wef_dryads_rank_7
wh2_dlc16_wef_berserker_trees	wh_dlc08_unit_passive_berserk	wef_dlc05_trees
wh2_dlc16_wef_cha_malicious_branchwraith_beasts_0_garrison_1	wh_dlc03_spell_beasts_wyssans_wildform	wh2_dlc16_wef_cha_malicious_branchwraith_beasts_0
wh2_dlc16_wef_shadows_coil_unmounted_glade_captain	wh_dlc05_unit_abilities_the_shadows_coil	wh2_twa02_wef_glade_captain_unmounted
wh2_dlc16_wef_sisters_call_to_ceithin_har	wh2_dlc16_lord_abilities_call_to_ceithin_har	wh2_dlc16_sisters_of_twilight_gwindalor_only
wh2_dlc16_wef_sisters_call_to_gwindalor	wh2_dlc16_lord_abilities_call_to_gwindalor	wh2_dlc16_sisters_of_twilight_ceithin_har_only
wh2_dlc16_wef_sisters_enable_hawk_riders_volley_of_kurnous	wh2_dlc16_unit_abilities_volley_of_kurnous	wef_hawk_riders
wh2_dlc17_ability_enable_frenzy_free_company_militia	wh_main_unit_passive_frenzy	emp_freecompany
wh2_dlc17_bloodgreed_upgraded_minotaurs	wh2_dlc17_unit_passive_bloodgreed_upgraded	bst_dlc03_minotaurs
wh2_dlc17_effect_ability_enable_horrible_regeneration	wh2_dlc17_unit_passive_horrible_regeneration	chs_spawns
wh2_dlc17_effect_ability_enable_horrible_regeneration_nor_trolls_skin_wolves	wh2_dlc17_unit_passive_horrible_regeneration	wh2_dlc17_throgg_focus_units_excluding_fimir
wh2_dlc17_effect_ability_enable_horrible_regeneration_rank7_spooky_units	wh2_dlc17_unit_passive_horrible_regeneration	wh2_dlc17_cairnwraith_hexwraith_rank7
wh2_dlc17_effect_ability_enable_horrible_regeneration_ror_spooky_units	wh2_dlc17_unit_passive_horrible_regeneration	wh2_dlc17_cairnwraith_hexwraith_ror
wh2_dlc17_effect_ability_enable_regeneration_fimir	wh_main_unit_passive_regeneration	dlc08_nor_fimirs
wh2_dlc17_effect_ability_enable_the_hunger_fellbats_direwolves	wh2_dlc11_unit_passive_the_hunger	wh2_dlc11_vmp_dire_wolves_fell_bats
wh2_dlc17_effect_ability_enable_wayfarer_clerical_units	wh2_dlc17_unit_passive_wayfarer	wh2_dlc17_volkmar_focus_units
wh2_dlc17_effect_ability_frenzy_throgg_focus_units	wh_main_unit_passive_frenzy	wh2_dlc17_throgg_focus_units
wh2_dlc17_effect_ability_upgrade_jabberslythe_aura	wh2_dlc17_unit_passive_greater_aura_of_madness	bst_dlc17_jabberslythes
wh2_dlc17_effect_cursed_attacks_vmp_rank7_spooky_units	wh2_dlc17_unit_passive_wightblades	wh2_dlc17_cairnwraith_hexwraith_ror
wh2_dlc17_effect_cursed_attacks_vmp_ror_spooky_units	wh2_dlc17_unit_passive_wightblades	wh2_dlc17_cairnwraith_hexwraith_rank7
wh2_dlc17_effect_enable_frenzy_bst_warhounds_harpies_razorgor_herd	wh_main_unit_passive_frenzy	wh2_dlc17_bst_warhounds_harpies_razorgor_herd
wh2_dlc17_effect_rune_stromni_redbeard_runesmiths	wh_main_rune_passive_master_rune_of_stromni_redbeard	dwf_runesmith
wh2_dlc17_guardian_ability_lords_heroes	wh2_dlc10_unit_passive_guardian	characters
wh2_dlc17_guardian_hammerers	wh2_dlc10_unit_passive_guardian	dwf_hammerers
wh2_dlc17_regen_minotaurs	wh_main_unit_passive_regeneration	bst_dlc03_minotaurs
wh2_dlc17_regeneration_spawn_jabberslythe	wh_main_unit_passive_regeneration	wh2_dlc17_spawn_jabberslythe
wh2_dlc17_skink_poison	wh2_dlc16_unit_passive_yewberry_infusion	lzd_skinks
wh2_dlc17_vmp_ability_enable_wayfarer__isabella_focus	wh2_dlc17_unit_passive_wayfarer	vmp_terrorgheist
wh2_dlc17_vmp_ability_enable_wayfarer_isabella_focus_2	wh2_dlc17_unit_passive_wayfarer	vmp_beasts
wh2_main_def_cha_sorceress_dark_0_garrison_1	wh2_main_spell_dark_magic_chillwind	wh2_main_def_cha_sorceress_dark_0
wh2_main_def_cha_sorceress_dark_0_garrison_2	wh2_main_spell_dark_magic_power_of_darkness	wh2_main_def_cha_sorceress_dark_0
wh2_main_hef_cha_mage_high_0_garrison_1	wh2_main_spell_high_magic_apotheosis	wh2_main_hef_cha_mage_high_0
wh2_main_hef_cha_mage_high_0_garrison_2	wh2_main_spell_high_magic_hand_of_glory	wh2_main_hef_cha_mage_high_0
wh2_main_lzd_cha_skink_priest_beasts_0_garrison_1	wh_dlc03_spell_beasts_wyssans_wildform	wh2_main_lzd_cha_skink_priest_beasts_0
wh2_main_lzd_cha_skink_priest_beasts_0_garrison_2	wh_dlc03_spell_beasts_flock_of_doom	wh2_main_lzd_cha_skink_priest_beasts_0
wh2_main_skv_cha_plague_priest_0_garrison_1	wh2_main_spell_plague_pestilent_breath	wh2_main_skv_cha_plague_priest_0
wh2_main_skv_cha_plague_priest_0_garrison_2	wh2_main_spell_plague_bless_with_filth	wh2_main_skv_cha_plague_priest_0
wh2_main_skv_cha_warlock_engineer_garrison_1	wh2_main_spell_ruin_scorch	wh2_main_skv_cha_warlock_engineer
wh2_twa02_heroic_killing_blow_glade_lords_captains	wh_main_character_abilities_heroic_killing_blow	wh2_twa02_wef_glade_lords_glade_captains
wh2_twa03_abyssal_howl_hydra	wh2_dlc10_unit_passive_abyssal_howl	def_hydra
wh2_twa03_another_takes_its_place_black_dragon	wh2_main_unit_passive_another_takes_its_place	def_dragons
wh2_twa03_frost_breath_kharybdiss	wh2_dlc10_unit_abilities_frost_breath	def_kharibdyss
wh2_twa03_murderous_prowess_indicator_monsters	wh2_main_faction_abilities_murderous_prowess_indicator	wh2_twa03_rakarth_monsters_in_monster_pen
wh2_twa03_murderous_prowess_monsters	wh2_main_faction_abilities_murderous_prowess	wh2_twa03_rakarth_monsters_in_monster_pen
wh2_twa03_ror_harpies_murderous_prowess	wh2_main_faction_abilities_murderous_prowess	mp_cap_unit_def_inf_harpies_ror
wh2_twa03_ror_harpies_murderous_prowess_indicator	wh2_main_faction_abilities_murderous_prowess_indicator	mp_cap_unit_def_inf_harpies_ror
wh2_twa03_ror_hydra_murderous_prowess	wh2_main_faction_abilities_murderous_prowess	wh2_dlc10_def_mon_chill_of_sontar_ror_0
wh2_twa03_ror_hydra_murderous_prowess_indicator	wh2_main_faction_abilities_murderous_prowess_indicator	wh2_dlc10_def_mon_chill_of_sontar_ror_0
wh3_dlc20_ability_enable_storm_rage_dragon_ogre	wh3_dlc20_unit_abilities_storm_rage	chs_dragon_ogres
wh3_dlc20_ability_enable_storm_rage_dragon_ogre_shaggoths	wh3_dlc20_unit_abilities_storm_rage	chs_dragon_ogre_shaggoths
wh3_dlc20_effect_ability_acid_ichor_plaguebearers	wh3_dlc20_character_passive_acid_ichor	nur_plaguebearers
wh3_dlc20_effect_ability_arcane_mirth_blue_horrors	wh3_main_unit_passive_arcane_mirth	wh3_main_tze_inf_blue_horrors_0
wh3_dlc20_effect_ability_cloud_of_flies_aspiring_champions	wh3_main_unit_passive_cloud_of_flies	wh3_dlc20_chs_aspiring_champions_only
wh3_dlc20_effect_ability_cloud_of_flies_chosen_mnur	wh3_main_unit_passive_cloud_of_flies	chosen_mnur
wh3_dlc20_effect_ability_enable_gift_of_chaos_aspiring_champions	wh3_dlc20_unit_passive_gift_of_chaos	wh3_dlc20_chs_aspiring_champions_only
wh3_dlc20_effect_ability_feasting_on_fear_fiends_of_slaanesh	wh3_main_lord_passive_feasting_on_fear	sla_fiends
wh3_dlc20_effect_ability_frenzy_aspiring_champions	wh_main_unit_passive_frenzy	wh3_dlc20_chs_aspiring_champions_only
wh3_dlc20_effect_ability_gate_of_tzeentch_aspiring_champions	wh3_main_character_abilities_gate_of_tzeentch	wh3_dlc20_chs_aspiring_champions_only
wh3_dlc20_effect_ability_gorefeast_aspiring_champions	wh3_main_unit_passive_gorefeast	wh3_dlc20_chs_aspiring_champions_only
wh3_dlc20_effect_ability_gorefeast_hounds_manticores_rank_4	wh3_main_unit_passive_gorefeast	chs_warhound_manticore_rank_4
wh3_dlc20_effect_ability_rage_rank_4_chs_dual_axes	wh_dlc08_unit_passive_rage	wh3_dlc20_chs_dual_axe_units_rank_4
wh3_dlc20_effect_ability_regen_aspiring_champions	wh_main_unit_passive_regeneration	wh3_dlc20_chs_aspiring_champions_only
wh3_dlc20_effect_ability_regeneration_rot_flies	wh_main_unit_passive_regeneration	nur_rot_flies_beast
wh3_dlc20_effect_ability_soulhunters_seeker_chariots	wh3_main_unit_passive_soul_hunters	sla_chariots
wh3_dlc20_effect_ability_wrath_of_khorne_bloodthirsters	wh3_main_lord_passive_wrath_of_khorne	wh3_main_kho_mon_bloodthirster_0
wh3_dlc20_feasting_on_fear_aspiring_champions	wh3_main_lord_passive_feasting_on_fear	wh3_dlc20_chs_aspiring_champions_only
wh3_dlc20_hellblade_aspiring_champions	wh3_main_unit_passive_hellblade	wh3_dlc20_chs_aspiring_champions_only
wh3_dlc20_hellblade_chosen_mkho	wh3_main_unit_passive_hellblade	chosen_mkho
wh3_dlc20_hidden_in_time_aspiring_champions	wh3_main_lord_abilities_hidden_in_time	wh3_dlc20_chs_aspiring_champions_only
wh3_dlc20_locus_of_fecundity_aspiring_champions	wh3_main_character_abilities_locus_of_fecundity	wh3_dlc20_chs_aspiring_champions_only
wh3_dlc20_revel_in_slaughter_aspiring_champions	wh3_main_lord_passive_revel_in_slaughter	wh3_dlc20_chs_aspiring_champions_only
wh3_dlc20_slime_trail_aspiring_champions	wh3_main_unit_passive_slime_trail	wh3_dlc20_chs_aspiring_champions_only
wh3_dlc20_slime_trail_chosen_mnur	wh3_main_unit_passive_slime_trail	chosen_mnur
wh3_dlc20_soulhunter_knights_msla	wh3_main_unit_passive_soul_hunters	chs_knights_msla
wh3_dlc20_soulhunters_aspiring_champions	wh3_main_unit_passive_soul_hunters	wh3_dlc20_chs_aspiring_champions_only
wh3_dlc23_chd_cha_daemonsmith_sorcerer_hashut_garrison_1	wh3_dlc23_spell_hashut_burning_wrath	wh3_dlc23_chd_cha_daemonsmith_sorcerer_hashut
wh3_dlc23_chd_cha_daemonsmith_sorcerer_hashut_garrison_2	wh3_dlc23_spell_hashut_dark_subjugation	wh3_dlc23_chd_cha_daemonsmith_sorcerer_hashut
wh3_dlc23_effect_ability_enable_restock_for_infernal_castellan	wh2_dlc17_hero_abilities_more_powder_generic	wh3_dlc23_chd_infernal_castellan
wh3_dlc23_effect_ability_mod_amount_of_uses_lammasu_bale_taurus	wh3_dlc23_unit_abilities_flaming_breath	wh3_dlc23_chd_monsters_rank7
wh3_dlc23_final_battle_final_boss_belegar	wh3_dlc23_lord_passive_presence_of_clan_angrund	wh3_dlc23_final_battle_final_boss_belegar
wh3_dlc23_final_battle_final_boss_slaughtermaster	wh3_dlc23_lord_passive_champions_of_the_maw	wh3_dlc23_final_battle_final_boss_slaughtermaster
wh3_dlc23_final_battle_final_boss_thorek	wh3_dlc23_lord_passive_presence_of_the_master_runelord	wh3_dlc23_final_battle_final_boss_thorek
wh3_dlc23_final_battle_final_boss_thorgrim	wh3_dlc23_lord_passive_presence_of_the_high_king	wh3_dlc23_final_battle_final_boss_thorgrim
wh3_dlc24_cth_cha_gate_master_garrison_1	wh3_dlc24_character_passive_bulwark_of_the_gate	wh3_dlc24_cth_cha_gate_master
wh3_dlc24_cth_cha_gate_master_garrison_2	wh3_dlc24_character_abilities_bastions_defenders	wh3_dlc24_cth_cha_gate_master
wh3_dlc24_effect_ability_cooldown_dragons_fang_dragon_form	wh3_dlc24_weapon_abilities_dragons_fang	wh3_dlc24_cth_cha_yuan_bo_dragon
wh3_dlc24_effect_ability_cooldown_dragons_fang_human	wh3_dlc24_weapon_abilities_dragons_fang	wh3_dlc24_cth_cha_yuan_bo_human
wh3_dlc24_effect_ability_enable_glean_magic_changeling	wh3_main_spell_tzeentch_glean_magic	just_the_changeling
wh3_dlc24_effect_ability_enable_infernal_gateway_changeling	wh3_main_spell_tzeentch_infernal_gateway	just_the_changeling
wh3_dlc24_effect_ability_enable_shield_of_thorns_passive_chs_knights_chosen_2	wh3_dlc24_passive_shield_of_thorns	chs_knights
wh3_dlc24_effect_ability_enable_shield_of_thorns_passive_chs_knights_chosen_4	wh3_dlc24_passive_shield_of_thorns	tze_doom_knights
wh3_dlc24_effect_ability_enable_tzeentch_treason_of_tzeentch_changeling	wh3_main_spell_tzeentch_treason_of_tzeentch	just_the_changeling
wh3_dlc24_effect_ability_enable_tzeentch_tzeentchs_firestorm_changeling	wh3_main_spell_tzeentch_tzeentchs_firestorm	just_the_changeling
wh3_dlc24_effect_ability_enable_yuan_human_blossom_wind	wh3_main_spell_yin_blossom_wind	wh3_dlc24_cth_cha_yuan_bo_human
wh3_dlc24_effect_ability_enable_yuan_human_net_of_amyntok	wh_main_spell_light_net_of_amyntok	wh3_dlc24_cth_cha_yuan_bo_human
wh3_dlc24_effect_ability_enable_yuan_human_talons_of_night	wh3_main_spell_yin_talons_of_night	wh3_dlc24_cth_cha_yuan_bo_human
wh3_dlc24_effect_ability_num_uses_war_compass	wh3_main_mount_bound_celestial_lightning	wh3_main_cth_veh_war_compass_0
wh3_dlc24_effect_ability_num_uses_war_compass_2	wh3_main_mount_bound_celestial_comet	wh3_main_cth_veh_war_compass_0
wh3_dlc24_effect_ability_overcast_blue_fire_of_tzeentch_changeling	wh3_main_spell_tzeentch_blue_fire_of_tzeentch	just_the_changeling
wh3_dlc24_effect_ability_overcast_glean_magic_changeling	wh3_main_spell_tzeentch_glean_magic	just_the_changeling
wh3_dlc24_effect_ability_overcast_infernal_gateway_changeling	wh3_main_spell_tzeentch_infernal_gateway	just_the_changeling
wh3_dlc24_effect_ability_overcast_pink_fire_of_tzeentch_changeling	wh3_main_spell_tzeentch_pink_fire_of_tzeentch	just_the_changeling
wh3_dlc24_effect_ability_overcast_treason_of_tzeentch_changeling	wh3_main_spell_tzeentch_treason_of_tzeentch	just_the_changeling
wh3_dlc24_effect_ability_overcast_tzeentchs_firestorm_changeling	wh3_main_spell_tzeentch_tzeentchs_firestorm	just_the_changeling
wh3_dlc24_effect_ability_overcast_yuan_human_blossom_wind	wh3_main_spell_yin_blossom_wind	wh3_dlc24_cth_cha_yuan_bo_human
wh3_dlc24_effect_ability_overcast_yuan_human_jade_shield	wh3_main_spell_yang_jade_shield	wh3_dlc24_cth_cha_yuan_bo_human
wh3_dlc24_effect_ability_overcast_yuan_human_net_of_amyntok	wh_main_spell_light_net_of_amyntok	wh3_dlc24_cth_cha_yuan_bo_human
wh3_dlc24_effect_ability_overcast_yuan_human_shems_burning_gaze	wh_main_spell_light_shems_burning_gaze	wh3_dlc24_cth_cha_yuan_bo_human
wh3_dlc24_effect_ability_overcast_yuan_human_talons_of_night	wh3_main_spell_yin_talons_of_night	wh3_dlc24_cth_cha_yuan_bo_human
wh3_dlc24_guardian_tzar_guards	wh2_dlc10_unit_passive_guardian	ksl_ice_guard_tzar_guard
wh3_dlc24_ksl_regen_hag_witches	wh_main_unit_passive_regeneration	wh3_dlc24_ksl_heroes_hags
wh3_dlc24_vmp_unit_fell_bats_regeneration	wh_main_unit_passive_regeneration	vmp_unit_fell_bats
wh3_dlc25_ability_enable_greater_gate_nur_garrisons	wh3_main_character_abilities_greater_gate_of_nurgle	wh3_main_nur_cha_cultist_0
wh3_dlc25_amethyst_outrider_murderous_charge	wh3_dlc20_unit_passive_murderous_charge	wh3_dlc25_emp_cav_outrider_morr
wh3_dlc25_dwf_cha_dragon_slayer_caravan_1	wh_main_lord_passive_deathblow	wh3_dlc25_dwf_cha_dragon_slayer
wh3_dlc25_effect_ability_aura_of_protection	wh_main_mount_passive_aura_of_protection	wh_dlc08_empire_luminark
wh3_dlc25_effect_ability_aura_of_protection_upgraded	wh3_dlc25_mount_passive_aura_of_protection_upgraded	wh_dlc08_empire_luminark
wh3_dlc25_effect_ability_enable_ahes_and_steam_amethyst_landship	wh3_dlc25_unit_passive_ashes_and_steam	wh3_dlc25_emp_veh_land_ship_morr
wh3_dlc25_effect_ability_enable_iron_resolve_amethyst_ironsides	wh3_dlc25_unit_passive_iron_resolve	wh3_dlc25_emp_inf_ironsides_morr
wh3_dlc25_effect_ability_enable_journeys_end_upgraded	wh3_dlc25_unit_passive_journeys_end_upgraded	dwf_slayers
wh3_dlc25_effect_ability_enable_last_rites_amethyst_rocket_battery	wh3_dlc25_unit_passive_last_rites	wh3_dlc25_emp_art_helstorm_rocket_battery_morr
wh3_dlc25_effect_ability_enable_regeneration_nur_nurglings_rank7	wh_main_unit_passive_regeneration	wh3_main_nur_inf_nurglings_0_rank7
wh3_dlc25_effect_ability_enable_regeneration_nur_nurglings_ror	wh_main_unit_passive_regeneration	wh3_twa10_nur_inf_nurglings_ror
wh3_dlc25_effect_ability_enable_weapons_of_malice_army	wh3_dlc25_unit_passive_weapons_of_malice	wh3_dlc25_nemesis_crown_final_battle_set
wh3_dlc25_effect_ability_mod_amount_of_uses_unspeakable_foulness_toad_dragons	wh3_dlc25_unit_abilities_unspeakable_foulness	wh3_dlc25_nur_mon_toad_dragon_and_tamurkhan
wh3_dlc25_effect_ability_whirlwind_of_death_doomseekers_disable	wh3_dlc25_unit_abilities_whirlwind_of_death	dwf_doomseekers_rank7
wh3_dlc25_effect_ability_whirlwind_of_death_doomseekers_ror_disable	wh3_dlc25_unit_abilities_whirlwind_of_death_ror	wh3_dlc25_dwf_inf_doomseekers_rank7_ror
wh3_dlc25_effect_ability_whirlwind_of_death_upgraded_doomseekers	wh3_dlc25_unit_abilities_whirlwind_of_death_upgraded	dwf_doomseekers_rank7
wh3_dlc25_effect_ability_whirlwind_of_death_upgraded_doomseekers_ror	wh3_dlc25_unit_abilities_whirlwind_of_death_ror_upgraded	wh3_dlc25_dwf_inf_doomseekers_rank7_ror
wh3_dlc25_effect_ritual_gunnery_school_land_ship_mines	wh3_dlc25_unit_abilities_marienburg_land_mines	wh3_dlc25_emp_land_ship
wh3_dlc25_emp_amethyst_ironsides_refuse_to_die	wh3_dlc25_unit_passive_iron_resolve	wh3_dlc25_emp_inf_ironsides_morr
wh3_dlc25_emp_elspeth_ashes_and_dust	wh3_main_cataclysm_death_ashes_and_dust	wh3_dlc25_emp_elspeth
wh3_dlc25_emp_land_ship_spearports	wh3_dlc25_unit_passive_spearports	wh3_dlc25_emp_land_ship
wh3_dlc25_emp_veh_land_ship_morr_doom_and_despair	wh3_dlc25_unit_passive_doom_and_despair	wh3_dlc25_emp_veh_land_ship_morr
wh3_dlc25_emp_veh_land_ship_morr_fate_of_bjuna	wh3_dlc25_spell_bound_the_fate_of_bjuna	wh3_dlc25_emp_veh_land_ship_morr
wh3_dlc25_emp_veh_land_ship_morr_spirit_leech	wh3_dlc25_spell_bound_spirit_leech_gunnery_school	wh3_dlc25_emp_veh_land_ship_morr
wh3_dlc25_grim_resolve_characters	wh2_dlc13_unit_passive_grim_resolve	characters
wh3_dlc25_gunnery_cavalry_extra_reload	wh3_dlc23_unit_passive_extra_reload	wh3_dlc25_gunnery_cavalry
wh3_dlc25_nur_chieftains_fimir_trolls_ogres_enable_horrible_regeneration	wh2_dlc17_unit_passive_horrible_regeneration	wh3_dlc25_nur_chieftains_fimir_trolls_beasts
wh3_dlc25_starmetal_plate_dwf_hammerers	wh2_dlc10_item_passive_starmetal_plate	dwf_hammerers
wh3_doom_and_darkness_amethsyt_land_ship	wh3_dlc25_spell_Bound_doom_and_darkness_gunnery_school	wh3_dlc25_emp_veh_land_ship_morr
wh3_main_cth_cha_alchemist_0_caravan_1	wh_main_spell_metal_searing_doom	wh3_main_cth_cha_alchemist_0
wh3_main_cth_cha_alchemist_0_caravan_2	wh_main_spell_metal_plague_of_rust	wh3_main_cth_cha_alchemist_0
wh3_main_cth_cha_alchemist_0_caravan_3	wh3_main_character_abilities_enchanted_metallurgy	wh3_main_cth_cha_alchemist_0
wh3_main_cth_cha_astromancer_garrison_1	wh_main_spell_heavens_harmonic_convergence	wh3_main_cth_cha_astromancer
wh3_main_cth_cha_astromancer_garrison_2	wh_main_spell_heavens_wind_blast	wh3_main_cth_cha_astromancer
wh3_main_effect_ability_cooldown_wrath_of_the_storm	wh3_main_lord_abilities_wrath_of_the_storm	wh3_main_cth_cha_storm_dragon_0
wh3_main_effect_ability_disable_deadly_onslaught_iron_dragon	wh_main_character_abilities_deadly_onslaught	wh3_main_cth_cha_iron_dragon_1
wh3_main_effect_ability_disable_deadly_onslaught_storm_dragon	wh_main_character_abilities_deadly_onslaught	wh3_main_cth_cha_storm_dragon_1
wh3_main_effect_ability_disable_earth_blood_storm_dragon	wh_dlc05_spell_life_earth_blood	wh3_main_cth_cha_storm_dragon_1
wh3_main_effect_ability_disable_flesh_to_stone_storm_dragon	wh_dlc05_spell_life_flesh_to_stone	wh3_main_cth_cha_storm_dragon_1
wh3_main_effect_ability_disable_foe_seeker_iron_dragon	wh_main_character_abilities_foe_seeker	wh3_main_cth_cha_iron_dragon_1
wh3_main_effect_ability_disable_foe_seeker_storm_dragon	wh_main_character_abilities_foe_seeker	wh3_main_cth_cha_storm_dragon_1
wh3_main_effect_ability_disable_master_of_alchemy_iron_dragon	wh3_main_lord_abilities_master_of_alchemy	wh3_main_cth_cha_iron_dragon_0
wh3_main_effect_ability_disable_missile_mirror_storm_dragon	wh3_main_spell_yin_missile_mirror	wh3_main_cth_cha_storm_dragon_1
wh3_main_effect_ability_disable_rally_iron_dragon	wh_main_character_abilities_rally	wh3_main_cth_cha_iron_dragon_1
wh3_main_effect_ability_disable_rally_storm_dragon	wh_main_character_abilities_rally	wh3_main_cth_cha_storm_dragon_1
wh3_main_effect_ability_disable_regrowth_storm_dragon	wh_dlc05_spell_life_regrowth	wh3_main_cth_cha_storm_dragon_1
wh3_main_effect_ability_disable_stand_your_ground_iron_dragon	wh_main_character_abilities_stand_your_ground	wh3_main_cth_cha_iron_dragon_1
wh3_main_effect_ability_disable_stand_your_ground_storm_dragon	wh_main_character_abilities_stand_your_ground	wh3_main_cth_cha_storm_dragon_1
wh3_main_effect_ability_disable_storm_of_shadows_storm_dragon	wh3_main_spell_yin_storm_of_shadows	wh3_main_cth_cha_storm_dragon_1
wh3_main_effect_ability_enable_acquiescence_keeper_of_secrets	wh3_main_spell_slaanesh_acquiescence_bound	wh3_main_sla_mon_keeper_of_secrets_0_no_ror
wh3_main_effect_ability_enable_arcane_mirth_tze_horrors	wh3_main_unit_passive_arcane_mirth	tze_blue_pink_horrors_no_exalted
wh3_main_effect_ability_enable_aura_of_majesty	wh3_main_lord_passive_aura_of_majesty	wh3_main_cth_cha_storm_dragon_1
wh3_main_effect_ability_enable_blue_fire_of_tzeentch_lord_of_change	wh3_main_spell_tzeentch_blue_fire_of_tzeentch_bound	wh3_main_tze_mon_lord_of_change_0_no_ror
wh3_main_effect_ability_enable_constellation_of_the_dragon_iron_dragon	wh3_main_spell_yang_constellation_of_the_dragon	wh3_main_cth_cha_iron_dragon_0
wh3_main_effect_ability_enable_deadly_onslaught_iron_dragon	wh_main_character_abilities_deadly_onslaught	wh3_main_cth_cha_iron_dragon_0
wh3_main_effect_ability_enable_deadly_onslaught_storm_dragon	wh_main_character_abilities_deadly_onslaught	wh3_main_cth_cha_storm_dragon_0
wh3_main_effect_ability_enable_disdain_of_the_dragons	wh3_main_lord_passive_disdain_of_the_dragons	wh3_main_cth_cha_storm_dragon_0
wh3_main_effect_ability_enable_earth_blood_storm_dragon	wh_dlc05_spell_life_earth_blood	wh3_main_cth_cha_storm_dragon_0
wh3_main_effect_ability_enable_eye_of_the_storm	wh3_main_lord_abilities_eye_of_the_storm	wh3_main_cth_cha_storm_dragon_1
wh3_main_effect_ability_enable_final_transmutation_iron_dragon	wh_main_spell_metal_final_transmutation	wh3_main_cth_cha_iron_dragon_0
wh3_main_effect_ability_enable_flesh_to_stone_storm_dragon	wh_dlc05_spell_life_flesh_to_stone	wh3_main_cth_cha_storm_dragon_0
wh3_main_effect_ability_enable_foe_seeker_iron_dragon	wh_main_character_abilities_foe_seeker	wh3_main_cth_cha_iron_dragon_0
wh3_main_effect_ability_enable_foe_seeker_storm_dragon	wh_main_character_abilities_foe_seeker	wh3_main_cth_cha_storm_dragon_0
wh3_main_effect_ability_enable_frenzy_flesh_hounds_minotaurs	wh_main_unit_passive_frenzy	wh3_main_kho_flesh_hounds_minotaurs
wh3_main_effect_ability_enable_frenzy_for_sabretusks	wh_main_unit_passive_frenzy	ogr_sabretusks
wh3_main_effect_ability_enable_glean_magic_lord_of_change	wh3_main_spell_tzeentch_glean_magic_bound	wh3_main_tze_mon_lord_of_change_0
wh3_main_effect_ability_enable_glittering_robe_iron_dragon	wh_main_spell_metal_glittering_robe	wh3_main_cth_cha_iron_dragon_0
wh3_main_effect_ability_enable_hysterical_frenzy_keeper_of_secrets	wh3_main_spell_slaanesh_hysterical_frenzy_bound	wh3_main_sla_mon_keeper_of_secrets_0
wh3_main_effect_ability_enable_infernal_gateway_lord_of_change	wh3_main_spell_tzeentch_infernal_gateway_bound	wh3_main_tze_mon_lord_of_change_0
wh3_main_effect_ability_enable_lash_of_slaanesh_keeper_of_secrets	wh3_main_spell_bound_lash_of_slaanesh_keeper_of_secrets	wh3_main_sla_mon_keeper_of_secrets_0_no_ror
wh3_main_effect_ability_enable_master_of_alchemy_flaming_iron_dragon	wh3_main_lord_abilities_master_of_alchemy_flaming	wh3_main_cth_cha_iron_dragon_0
wh3_main_effect_ability_enable_master_of_alchemy_iron_dragon	wh3_main_lord_abilities_master_of_alchemy	wh3_main_cth_cha_iron_dragon_0
wh3_main_effect_ability_enable_master_of_alchemy_piercing_iron_dragon	wh3_main_lord_abilities_master_of_alchemy_piercing	wh3_main_cth_cha_iron_dragon_0
wh3_main_effect_ability_enable_master_of_alchemy_poison_iron_dragon	wh3_main_lord_abilities_master_of_alchemy_poison	wh3_main_cth_cha_iron_dragon_0
wh3_main_effect_ability_enable_mimic_battle_harmony_elf	wh3_main_unit_abilities_mimic_battle_harmony_elf	wh2_dlc15_mistwalkers
wh3_main_effect_ability_enable_mimic_brutish_charge	wh3_main_unit_abilities_mimic_brutish_charge	wh2_dlc15_mistwalkers
wh3_main_effect_ability_enable_mimic_by_our_blood	wh3_main_unit_abilities_mimic_by_our_blood	wh2_dlc15_mistwalkers
wh3_main_effect_ability_enable_missile_mirror_storm_dragon	wh3_main_spell_yin_missile_mirror	wh3_main_cth_cha_storm_dragon_0
wh3_main_effect_ability_enable_nurgle_curse_of_the_leper	wh3_main_spell_nurgle_curse_of_the_leper_bound	wh3_main_nur_mon_great_unclean_one_0
wh3_main_effect_ability_enable_nurgle_fleshy_abundance	wh3_main_spell_nurgle_fleshy_abundance_bound	wh3_main_nur_mon_great_unclean_one_0
wh3_main_effect_ability_enable_nurgle_miasma_of_pestilence	wh3_main_spell_nurgle_miasma_of_pestilence_bound	wh3_main_nur_mon_great_unclean_one_0_no_ror
wh3_main_effect_ability_enable_nurgle_pestilent_pustule	wh3_main_spell_nurgle_pestilent_pustule_bound	wh3_main_nur_mon_great_unclean_one_0
wh3_main_effect_ability_enable_nurgle_rancid_visitations	wh3_main_spell_nurgle_rancid_visitations_bound	wh3_main_nur_mon_great_unclean_one_0
wh3_main_effect_ability_enable_nurgle_stream_of_corruption	wh3_main_spell_nurgle_stream_of_corruption_bound	wh3_main_nur_mon_great_unclean_one_0
wh3_main_effect_ability_enable_pavane_of_slaanesh_keeper_of_secrets	wh3_main_spell_slaanesh_pavane_of_slaanesh_bound	wh3_main_sla_mon_keeper_of_secrets_0
wh3_main_effect_ability_enable_phantasmagoria_keeper_of_secrets	wh3_main_spell_slaanesh_phantasmagoria_bound	wh3_main_sla_mon_keeper_of_secrets_0
wh3_main_effect_ability_enable_pink_fire_of_tzeentch_lord_of_change	wh3_main_spell_tzeentch_pink_fire_of_tzeentch_bound	wh3_main_tze_mon_lord_of_change_0_no_ror
wh3_main_effect_ability_enable_plague_of_rust_iron_dragon	wh_main_spell_metal_plague_of_rust	wh3_main_cth_cha_iron_dragon_0
wh3_main_effect_ability_enable_rally_dragon	wh_main_character_abilities_rally	wh3_dlc24_cth_dragons_human_form
wh3_main_effect_ability_enable_regen_dragon_ogre_frost_wyrm	wh_main_unit_passive_regeneration	wh3_dlc25_nur_chieftains_fimir_frost_wyrm_dragon_ogre
wh3_main_effect_ability_enable_regeneration_ksl_elemental_bears	wh_main_unit_passive_regeneration	wh3_main_ksl_mon_elemental_bear_0
wh3_main_effect_ability_enable_regeneration_nurglings	wh_main_unit_passive_regeneration	wh3_main_nur_inf_nurglings_0
wh3_main_effect_ability_enable_regrowth_storm_dragon	wh_dlc05_spell_life_regrowth	wh3_main_cth_cha_storm_dragon_0
wh3_main_effect_ability_enable_slicing_shards_keeper_of_secrets	wh3_main_spell_slaanesh_slicing_shards_bound	wh3_main_sla_mon_keeper_of_secrets_0
wh3_main_effect_ability_enable_slime_trail_great_unclean_one	wh3_main_unit_passive_slime_trail	wh3_main_nur_mon_great_unclean_one_0
wh3_main_effect_ability_enable_stand_your_ground_dragon	wh_main_character_abilities_stand_your_ground	wh3_dlc24_cth_dragons_human_form
wh3_main_effect_ability_enable_storm_of_shadows_storm_dragon	wh3_main_spell_yin_storm_of_shadows	wh3_main_cth_cha_storm_dragon_0
wh3_main_effect_ability_enable_treason_of_tzeentch_lord_of_change	wh3_main_spell_tzeentch_treason_of_tzeentch_bound	wh3_main_tze_mon_lord_of_change_0
wh3_main_effect_ability_enable_tzeentchs_firestorm_lord_of_change	wh3_main_spell_tzeentch_tzeentchs_firestorm_bound	wh3_main_tze_mon_lord_of_change_0
wh3_main_effect_ability_enable_wall_of_wind_and_fire_iron_dragon	wh3_main_spell_yang_wall_of_wind_and_fire	wh3_main_cth_cha_iron_dragon_0
wh3_main_effect_ability_enable_wrath_of_the_storm	wh3_main_lord_abilities_wrath_of_the_storm	wh3_main_cth_cha_storm_dragon_0
wh3_main_kho_veh_blood_shrine_0_blood_shield	wh2_dlc16_hero_passive_blood_shield	wh3_main_kho_veh_blood_shrine_0
wh3_main_ksl_bear_riders_frenzy	wh_main_unit_passive_frenzy	wh3_main_ksl_bear_riders
wh3_main_nur_cha_plagueridden_death_garrison_1	wh_main_spell_death_aspect_of_the_dreadknight	wh3_main_nur_cha_plagueridden_death
wh3_main_nur_cha_plagueridden_death_garrison_2	wh_main_spell_death_spirit_leech	wh3_main_nur_cha_plagueridden_death
wh3_main_nur_cha_plagueridden_nurgle_garrison_1	wh3_main_spell_nurgle_stream_of_corruption	wh3_main_nur_cha_plagueridden_nurgle
wh3_main_nur_cha_plagueridden_nurgle_garrison_2	wh3_main_spell_nurgle_miasma_of_pestilence	wh3_main_nur_cha_plagueridden_nurgle
wh3_main_ogr_cha_firebelly_0_garrison_1	wh_main_spell_fire_fireball	wh3_main_ogr_cha_firebelly_0
wh3_main_ogr_cha_firebelly_0_garrison_2	wh_main_spell_fire_cascading_fire_cloak	wh3_main_ogr_cha_firebelly_0
wh3_main_ravenous_dead_crypt_horrors	wh2_dlc11_unit_passive_the_hunger	vmp_unit_crypt_horrors
wh3_main_ravenous_dead_ghouls	wh2_dlc11_unit_passive_the_hunger	vmp_ghouls
wh3_main_sla_cha_alluress_shadow_garrison_1	wh_dlc05_spell_shadow_melkoths_mystifying_miasma	wh3_main_sla_cha_alluress_shadow
wh3_main_sla_cha_alluress_shadow_garrison_2	wh_dlc05_spell_shadow_the_enfeebling_foe	wh3_main_sla_cha_alluress_shadow
wh3_main_sla_cha_alluress_slaanesh_garrison_1	wh3_main_spell_slaanesh_lash_of_slaanesh	wh3_main_sla_cha_alluress_slaanesh
wh3_main_sla_cha_alluress_slaanesh_garrison_2	wh3_main_spell_slaanesh_acquiescence	wh3_main_sla_cha_alluress_slaanesh
wh3_main_sla_cha_herald_of_slaanesh_slaanesh_0_garrison_1	wh3_main_spell_slaanesh_acquiescence	wh3_main_sla_cha_herald_of_slaanesh_slaanesh_0
wh3_main_sla_cha_herald_of_slaanesh_slaanesh_0_garrison_2	wh3_main_spell_slaanesh_lash_of_slaanesh	wh3_main_sla_cha_herald_of_slaanesh_slaanesh_0
wh3_main_tze_cha_cultist_0_garrison_1	wh_main_spell_fire_fireball	tze_cultist
wh3_main_tze_cha_cultist_0_garrison_2	wh_main_spell_fire_cascading_fire_cloak	tze_cultist
wh3_main_tze_cha_iridescent_horror_metal_garrison_1	wh_main_spell_metal_plague_of_rust	wh3_main_tze_cha_iridescent_horror_metal
wh3_main_tze_cha_iridescent_horror_metal_garrison_2	wh_main_spell_metal_searing_doom	wh3_main_tze_cha_iridescent_horror_metal
wh3_main_tze_cha_iridescent_horror_tzeentch_garrison_1	wh3_main_spell_tzeentch_blue_fire_of_tzeentch	wh3_main_tze_cha_iridescent_horror_tzeentch
wh3_main_tze_cha_iridescent_horror_tzeentch_garrison_2	wh3_main_spell_tzeentch_pink_fire_of_tzeentch	wh3_main_tze_cha_iridescent_horror_tzeentch
wh3_twa08_effect_ability_enable_enfeebling_foe_keeper_of_secrets_ror	wh3_twa08_spell_bound_enfeebling_foe_keeper_of_secrets_ror	mp_cap_unit_sla_mon_keeper_of_secrets_0_ror
wh3_twa08_effect_ability_enable_gehennas_golden_hounds_lord_of_change_ror	wh3_dlc20_spell_bound_gehennas_golden_hounds	mp_cap_unit_tze_mon_lord_of_change_0_ror
wh3_twa08_effect_ability_enable_lash_of_slaanesh_keeper_of_secrets_ror	wh3_main_spell_bound_lash_of_slaanesh_keeper_of_secrets	mp_cap_unit_sla_mon_keeper_of_secrets_0_ror
wh3_twa08_effect_ability_enable_searing_doom_lord_of_change_ror	wh3_twa08_spell_bound_searing_doom	mp_cap_unit_tze_mon_lord_of_change_0_ror
wh3_twa08_effect_ability_enable_spirit_leech_great_unclean_one_ror	wh3_twa08_spell_bound_spirit_leech_great_unclean_one_ror	mp_cap_unit_nur_mon_great_unclean_one_0_ror
wh_dlc03_bst_cha_bray_shaman_wild_0_garrison_1	wh_dlc03_spell_wild_viletide	wh_dlc03_bst_cha_bray_shaman_wild_0
wh_dlc03_bst_cha_bray_shaman_wild_0_garrison_2	wh_dlc03_spell_wild_devolve	wh_dlc03_bst_cha_bray_shaman_wild_0
wh_dlc05_wef_cha_spellsinger_life_0_garrison_1	wh_dlc05_spell_life_awakening_of_the_wood	wh_dlc05_wef_cha_spellsinger_life_0
wh_dlc05_wef_cha_spellsinger_life_0_garrison_2	wh_dlc05_spell_life_earth_blood	wh_dlc05_wef_cha_spellsinger_life_0
wh_main_brt_cha_damsel_0_garrison_1	wh_main_spell_heavens_harmonic_convergence	wh_main_brt_cha_damsel_0
wh_main_brt_cha_damsel_0_garrison_2	wh_main_spell_heavens_wind_blast	wh_main_brt_cha_damsel_0
wh_main_emp_cha_wizard_fire_0_garrison_1	wh_main_spell_fire_fireball	wh_main_emp_cha_wizard_fire_0
wh_main_emp_cha_wizard_fire_0_garrison_2	wh_main_spell_fire_cascading_fire_cloak	wh_main_emp_cha_wizard_fire_0
wh_main_grn_cha_orc_shaman_0_garrison_1	wh_main_spell_big_waaagh_gaze_of_mork	wh_main_grn_cha_orc_shaman_0
wh_main_grn_cha_orc_shaman_0_garrison_2	wh_main_spell_big_waaagh_brain_bursta	wh_main_grn_cha_orc_shaman_0
wh_main_vmp_cha_necromancer_0_garrison_1	wh_main_spell_vampires_invocation_of_nehek	wh_main_vmp_cha_necromancer_0
wh_main_vmp_cha_necromancer_0_garrison_2	wh_main_spell_vampires_vanhels_danse_macabre	wh_main_vmp_cha_necromancer_0
wh_main_vmp_cha_vampire_0_garrison_1	wh_main_spell_death_spirit_leech	wh_main_vmp_cha_vampire_0
